ptg000003l polypolish	reverse	GGGTTAGGGTTAGGGTTAGGGTTAGGGTTAGGGTTAGGGTTAGGGTTAGGGTTAGGGTTAGGGATACGAGTTACGGGCCTAACACACAGCATACGAGACT
ptg000008l polypolish	forward	ATGGTCTATTTCACCGTATACTACCCTAACCCTAACCCTACCCTAACCCTAACCCTAACCCTAACCCTAACCCTAACCCTAACCCTAACCCTAACCCTAA
ptg000014l polypolish	reverse	GGTTAGGGTTAGGGTTAGGGTTAGGGTTAGGGTTAGGGTTAGGGTTAGGGTTAGGGTTAGGGTTAGGGTTAGGGTTAGGGTTAGGAGACCTAGGCGTTAG
ptg000016l polypolish	forward	GTGTTATGTTAATCATTATGTCTGCTATGCCTAATGCTTAGGTATAATCTACGTAGCTCCTAACCCTAACCCTAACCCTAACCCTAACCCTAACCCTAAC
ptg000022l polypolish	forward	TCAACGGTGTTGAGATATGTTTTATGTCTAGCCGTGTTCCATTACCGTATTGCTCCCTAACCCTAACCCTAACCCTAACCCTAACCCTAACCCTAACCCT
ptg000032l polypolish	reverse	GTTAGGGTTAGGGTTAGGGTTAGGGTTAGGGTTAGGGTTAGGGTTAGGGTTAGGGTAGTAGGAGCGAATAGGTTATGACATAATGAGTAATAGGTATATA
ptg000047l polypolish	reverse	TTAGGGTTAGGGTTAGGGTTAGGGTTAGGGTTAGGGTTAGGGTTAGGGTTAGGGTTAGGGTTAGGGTTAGGGTTAGGGTTAGGGTTAGCTAGCATAGGGT
ptg000059l polypolish	forward	ACCCTAACCCTTTATGACCTTAGGTTACATATACTACCCTAACCCTAACCCTAACCCTAACCCTAACCCTAACCCTAACCCTAACCCTAACCCTAACCCT
ptg000060l polypolish	reverse	TAGGGTTAGGGTTAGGGTTAGGGTTAGGGTTAGGGTTAGGGTTAGGGTTAGGGTTAGGGTTAGGGTTAGGGTTAGGGTTAGGGTATAGAGCCATTGGGTG
ptg000075l polypolish	forward	TAACCCTAACCCTAACCCTAACCCTAACCCTAACCCTAACCCTAACCCTAACCCTAACCCTAACCCTAACCCTAACCCTAACCCTAACCCTAACCCTAAC
ptg000101l polypolish	forward	ATGTTTAACCCTAACCCTAACCCTAACCCTAACCCTTACCCTAACCCTAACCCTAACCCTAACCCTAACCCTAACCCTAACCCTAACCCTAACCCTAACC
ptg000124l polypolish	forward	ATGTGTAACCTACTTGGTTCAGGTACGTAGCCCTAACCCTAACCCTAACCCTAACCCTAACCCTAACCCTAACCCTAACCCTAACCCTAACCCTAACCCT
ptg000136l polypolish	reverse	GTTAGGGTTAGGGTTAGGGTTAGGGTTAGGGTTAGGGTTAGGGTTAGGGTTTAGGGTTAGGGTTAGGGTAGTATGATCCAACTGAACCTAGTATAGGGCA
ptg000158l polypolish	forward	CTACGTATTGCTAACCCTAACCCTAACCCTAACCCTAACCCTAACCCTAACCCTAACCCTAACCCTAACCCTAACCCTAACCCTAACCCTAACCCTAACC
ptg000169l polypolish	forward	TATTACATGTTACTATGTACACTAATTCATACATATACTACCCTAACCCTAACCCTAACCCTAACCCTAACCCTAACCCTAACCCTAACCCTAACCCTAA
ptg000179l polypolish	forward	TATTAACCCTAACCCTAACCCTAACCCTAACCCTAACCCTAACCCTAACCCTAACCCCTAACCCTAACCCTAACCCTAACCCTAACCCTAACCCTAACCC
ptg000180l polypolish	forward	CTGATGTTCATATTGCTGTTCCTTGGTTCAGTTACGTATTCTAACCCTACACCCTAACCCTAACCCTAACCCTAACCCTAACCCTAACCCTAACCCTAAC
ptg000186l polypolish	forward	CTAACCCTAACCCTAACCCTAACCCTAACCCTAACCCTAACCCTAACCCTAACCCTAACCCTAACCCTAACCCTAACCCTAACCCTAACCCTAACCCTAA
ptg000198l polypolish	forward	CAATTATGCTCCCTAACTGCTGAGCTCTAACCCTAACCCTAACCCTAACCCTAACCCTAACCCTAACCCTAACCCTAACCCTAACCCTAACCCTAACCCT
ptg000199l polypolish	forward	GTGTACCTCTTCATCAGGTTAGCATGCGACTAACCTAAGCTCTGGTACCCTAACCCTATTGCTCCCTAACCCTAACCCTAACCCTAACCCTAACCCTAAC
ptg000215l polypolish	reverse	GGTTAGGGTTAGGGTTAGGGTTAGGGTTAGGGTTAGGGTTAGGGTTAGGGTTAGGGTTAGGGTTAGGGTTAGGGTTAGGGTTAGGGTTAGGCAATACGGA
ptg000220l polypolish	reverse	GGGTTAGGGTTAGGGTTAGGGTTAGGGTTAGGGTTAGGGTTAGGGTTAGGGTTAGGGTTAGGGTTAGGGTTAGGGTTAGGGTTAGGGTTAGGGTTAGGGT
ptg000228l polypolish	forward	TATGTGTCTACCCTAACCTAGTTACGTATTGCTAACCCTAACCCTAACCCTAACCCTAACCCTAACCCTAACCCTAACCCTAACCCTAACCCTAACCCTA
ptg000232l polypolish	reverse	TTAGGGTTAGGGTTAGGGTTAGGGTTAGGGTTAGGGTTAGGGTTAGGGTTAGGGTTAGGGTTAGGAGCAAGACTGAACTTAGTCCAATGGTTAGAAGAAT
ptg000234l polypolish	reverse	TTAGGGTTAGGGTTAGGGTTAGGGTTAGGGTTAGGGTTAGGGTTAGGGTTAGGGTTAGGGTTCACGGAGCAATAGTTAACTGAACCAAGCACAGGCACAT
ptg000240l polypolish	forward	GTATGCTCCGGCAGTTAACGATTGTCTAACCCTAACCCTAACCCTAACCCTAACCCTCCTAACCCTAACCCTAACCCTAACCCTAACCCTAACCCTAACC
ptg000253l polypolish	forward	TAACCCTAACCCTAACCCTAACCCTAACCCTAACCCTAACCCTAACCCTAACCCTAACCCTAACCCTAACCCTAACCCTAACCCTAACCCTAACCCTAAC
ptg000253l polypolish	reverse	TAGGGTTAGGGTTAGGGTTAGGGTTAGGGTTAGGGTTAGGGTTAGGGTTAGGGTTAGGGTTAGGGTTAGGGTTTAGGGTTAGGGTTAGAGTTAGATGTGA
ptg000255l polypolish	forward	GTTAGTTAACCCTACTTGGTTAGGTTGGTCTTACTACCCTAACCCTAACCCTAACCCTAACCCTAACCCTAACCCTAACCCTAACCCTAACCCTAACCCT
ptg000257l polypolish	reverse	GGGTTAGGGTTAGGGTTAGGGTTAGGGTTAGGGTTAGGGTTAGGGTTAGGGTTAGGGTTAGGGTTAGGGTTAGGGTTAGGGTTAGGGTTAGGGTTAGGGT
ptg000260l polypolish	forward	TGTGCCTGTTACTTGGTTCAGTTAAGTCTATCCCTTTACTATGTCCTCTGCTTTGGTTCAGTTAGTCTTACCCTAACCCTAACCCTAACCCTAACCCTAA
ptg000265l polypolish	reverse	GGGTTAGGGTTAGGGTTAGGGTTAGGGTTAGGGTTAGGGTTAGGGTTAGGGTTAGGGTTAGGGTTATAGCTAACTGAATGAGTAGGTCAGACATAAACAT
ptg000270l polypolish	forward	ACCCTAACCCTAACCCTAACCCTAACCCTATACCCTAACCCTAACCCTAACCCTAACCCTAACCCTAACCCTAACCCTAACCCTAACCCTAACCCTAACC
ptg000273l polypolish	forward	ATTCTCTAATAATCCTAACCCTAACCTAATTGCTAACCCTAACCCTAACCCTAACCCTAACCCTAACCCTAACCCTAACCCTAACCCTAACCCTAACCCT
ptg000281l polypolish	reverse	TTAGGGTTAGGGTTAGGGTTAGGGTTAGGGTTAGGGTTAGGGTTAGGGTTAGGGTTAGGGTTAGGGTTAGGGTTAGGGTTAGGGTTAGGGTTAGGGTTAG
ptg000289l polypolish	forward	TAACCCTAACCCTAACCCTAACCCTAACCCTAACCCTAACCCTAACCCTAACCCTAACCCTAACCCTAACCCTAACCCTAACCCTAACCCTAACCCTAAC
ptg000295l polypolish	forward	CTTACAGGCAGATGACTTCGTTCAGGTTACATTGCTACTAACCCTAACCCTAACCCTAACCCTAACCCTAACCCTAACCCTAACCCTAACCCTAACCCTA
ptg000296l polypolish	reverse	GTTAGGGTTAGGGTTAGGGTTAGGGTTAGGGTTAGGGTTAGGGTTAGGGTTAGGGTTAGGGTTAGGGTTAGGGTTAGGGTTAGGGTTAGGGTTAGCTTTG
ptg000311l polypolish	reverse	TTAGGGTTAGGGTTAGGGTTAGGGTTAGGGTTAGGGTTAGGGTTAGGGTTAGGGTTAGCTGAGACAAGGGCATGAAGTAAGAATGGGTAGGGTTACGACT
ptg000323l polypolish	reverse	AGGGTTAGGGTTAGGGTTAGGGTTAGGGTTAGGGTTAGGGTTAGGGTTAGGGTTAGGGTTAGGGTTAGGGTTAGGAGTAATTAAGAGTTAGGTAGACATA
ptg000328l polypolish	forward	TTGCCTGTCTTGGTTCAGTTACGTATTGCTCCCTAACCCTAACCCTAACCCTAACCCTAACCCTAACCCTAACCCTAACCCTAACCCTAACCCTAACCCT
ptg000329l polypolish	reverse	TAGGGTTAGGGTTAGGGTTAGGGTTAGGGTTAGGGTTAGGGTTAGGGTTAGGGTTAGGAGTCAATAGCATGTAACTGAACGAAGTTAGGGTTAGACATAA
ptg000337l polypolish	reverse	TAGGGTTAGGGTTAGGGTTAGGGTTAGGGTTAGGGTTAGGGTTAGGGTTAGGGTTAGGGTTAGGGTTAGGGTATATAGAGTAACTGAACGAATAGCAGAT
ptg000347l polypolish	forward	GTCTTATCCCTATAACCTATTGCATCTCTAACTCTAAGGCTTACTAACCCTAACCCTAACCCTAACCCTAACCCTAACCCTAACCCTAACCCTAACCCTA
ptg000366l polypolish	forward	CTAAATTCCAGTTTCAACTAACCCTAACCAACTAACCCTAACCCTAACCCTAACCCTAACCCTAACCCTAACCCTAACCCTAACCCTAACCCTAACCCTA
ptg000367l polypolish	forward	TTGCAATGCCTTGGATCAGAGTCTACTTGGTTCACTAACCCTATAACTATAACCCTAACCCTAACCCTAACCCTAACCCTAACCCTAACCCTAACCCTAA
ptg000369l polypolish	reverse	TAGGGTTAGGGTTAGGGTTAGGGCAATCTAGGGTTAGGGTCTAGGGTTAGGGTTAGGGTTACGGGTTAGGGAGCAATCGATGTTGGGTAGCAAACATACT
ptg000370l polypolish	reverse	AGGGTTAGGGTTAGGGTTAGGGTTAGGGTTAGGGTTAGGGTTAGGGTTAGGGTTAGGGTTAGGGTTAGGGTAGAATTGGTACCTAATCAGGCGGATAAAA
ptg000375l polypolish	reverse	GGTTAGGGTTAGGGTTAGGGTTAGGGTTAGGGTTAGGGTTAGGGTTAGGGTTAGGGTTAGGGTTAGCAATACATAAGTGCTGAAGTCGAAGCAAGGGCAA
ptg000410l polypolish	reverse	AGGGTTAGGGTTAGGGTTAGGGTTAGGGTTAGGGTTAGGGTTAGGGTTAGGGTTAGGGTTAGAGCAATACGTAACTGAACGAAGTAGGTATACATAAACT
ptg000418l polypolish	forward	ATGTTTATGCCTAACACCTAGGTCACTAGGTATTGCTCCCTAACCCTAACCCTAACCCTAACCCTAACCCTAACCCTAACCCTAACCCTAACCCTAACCC
ptg000422l polypolish	forward	TATACCCTAACCCTAACCCTAACCCTAACCCTAACCCTAACCCTAACCCTAACCCTAACCCTAACCCTAACCCTAACCCTAACCCTAACCCTAACCCTAA
ptg000425l polypolish	reverse	AGGGTTAGGGTTAGGGTTAGGGTTAGGGTTAGGGTTAGGGTTAGGGTTAGGGTTAGGGTTAGGGTTAGGGTTAGGGTTAGGGTTAGGGAGCAATACGATG
ptg000435l polypolish	forward	TATGTAACATTACTCTAAACCATATATACTAACCCTAACCCTAACCCTAACCCTAACCCTAACCCTAACCCTAACCCTAACCCTAACCCTAACCCTAACC
ptg000441l polypolish	reverse	GGGTTAGGGTTAGGGTTAGGGTTAGGGTTAGGGTTAGGGTTAGGGTTAGAGCAAGTTAGTTAGGGTTAGGGTTACACATAGGGTAGGGTTAGGACAGGTG
ptg000450l polypolish	forward	ATTCTACGCTGACATATTCAGTATGGTCTTATCGTAGCCTAAGCCTAAGCCTAAGCCTAACCCTAACCCTAACCCTAACCCTAACCCTAACCCTAACCCT
ptg000458l polypolish	forward	TTTTATGTGCCCTCTGCTTTGGTTCAGTGTAACCCTAACTCATATTGCTAACCCTAACCCTAACCCTAACCCTAACCCTAACCCTAACCCTAACCCTAAC
ptg000459l polypolish	reverse	GGGTTAGGGTTAGGGTTAGGGTTAGGGTTAGGGTTAGGGTTAGGGTTAGGGTTAGGGTTAGGGTTAGGGTTAGTTACGTTAGGGTTAGGGTTAGAATACA
ptg000469l polypolish	reverse	AGGGTTAGGGTTAGGGTTAGGGTTAGGGTTAGGGTTAGGGTTAGGGTTAGGGTTAGGGTTAGGTTAGCAATACGTAAACTGAACCAGTAGGGTTACACAT
ptg000474l polypolish	reverse	AGGGTTAGGGTTAGGGTTAGGGTTAGGGTTAGGGTTAGGGTTAGGGTTAGGGTTAGGGTTAGGGTAGGTATAATCTAACTGAGCGAGTGGTGGGCATAAA
ptg000477l polypolish	forward	ACCCTAACCCTAACCCTAACCCTAACCCTAACCCTAACCCTAACCCTAACCCTAACCCTAACCCTAACCCTAACCCTAACCCTAACCCTAACCCTAACCC
ptg000477l polypolish	reverse	TTAGGGTTAGGGTTAGGGTTAGGGTTAGGGTTAGGGGTTAGGGTTAGGGTTAGGGTTAGGGTTAGGAGTTAGACCCAAGTTAGTTTAGGTTATATAACAT
ptg000491l polypolish	forward	TGATTGGTTCCGTTACCTATTGCTCCCTAACCCTAACCCTAACCCTAACCCTAACCCTAACCCTAACCCTAACCCTAACCCTAACCCTAACCCTAACCCT
ptg000496l polypolish	forward	ATATTCTATACTACTATTGGACTACACTTAGTTAGTGTTTGCTCCTAACCCTAACCCTAACCCTAACCCTAACCCTAACCCTAACCCTAACCCTAACCCT
ptg000507l polypolish	reverse	TTAGGGTTAGGGTTAGGGTTAGGGTTAGGGTTAGGGTTAGGGTTAGGGCAATAGGGTAGTCTAAGGGTTAGGGTTAGGGTTAGGGTTAGGGTTAGGGTTA
ptg000520l polypolish	forward	ATCGTATTGAACCGTAACACTTACCCTACGTATAACCCTAACCCTAACCCTAACCCTAACCCTAACCCTAACCCTAACCCTAACCCTAACCCTAACCCTA
ptg000523l polypolish	reverse	GGTTAGGGTTAGGGTTAGGGTTAGGGTTAGGGTTAGGGTTAGGGTTAGGGTTAGGGTAGTATATGGTTAGGGACAACCTGAGTCTAAAGTTAGGGTTAAC
ptg000526l polypolish	reverse	TAGGGTTAGGGTTAGGGTTAGGGTTAGGGTTAGGGTTAGGGTTAGGGTTAGGGTTAGGGTTAGGGTTAGAGGCAATACTAGGTTCTTAGGGTACGTAACA
ptg000546l polypolish	forward	TGTGTAATTTGGTTCATGTTTAAGCCTAAGGATAAGCTCAACCATGTCTTACCCTAAGCCTAACCCTAACGCCTAAGCCTAACCCTAACCCTAACCCTAA
ptg000566l polypolish	reverse	AGGGTTAGGGTTTAGGGTTAGGGTTAGGGTTAGGGTTAGGGTTAGGGTTAGGGTTAGGGTTAGGAGCAATACCTAATCCTGAACCAAGGTAAGCCTTATA
ptg000571l polypolish	reverse	AGGGTTAGGGTTAGGGTTAGGGTTAGGGTTAGGGTTAGGGTTAGGGTTAGGGTTAGGGTTAGGGTTAGGGTTAGGGTTAGGGTTAGGGTTAGGGTTAGGG
ptg000575l polypolish	forward	ATGCCTACTCGTTCAGTTACGTATTGCTCCTAACCCTAAACCCTAACCCTAACCCTAACCCTAACCCTAACCCTAACCCTAACCCTAACCCTAACCCTAA
ptg000582l polypolish	forward	TTTACTACAGCCTAACTGGTTCAGTTAGTATTGCTCCTAACCCTAACCCTAACCCTAACCCTAACCCTAACCCTAACCCTAACCCTAACCCTAACCCTAA
ptg000590l polypolish	reverse	TTAGGGTTAGGGTTAGGGTTAGGGTTAGGGTTAGGGTTAGGGTTAGGGTTAGGGTTAGGGTTAGGGTTAGGGAATAGGTTAGGTTAGGGAGCAATAGGTG
ptg000593l polypolish	reverse	GGGTTAGGGTTAGGGTTAGGGTTAGGGTTAGGGTTAGGGTTAGGGTTAGGGTTAGGGTTAGGGTTAGGGTTAGGGTTAGGGTTAGGGTTAGGGTTAGGGT
ptg000595l polypolish	forward	CACTTAGTTAGATACATATGCTACCCTAACATTAACCCTAACCCTAATTTAACCCTAACCCTAACCCTAAATGCTAACCCTGTACCCTAACCCTAACCCT
ptg000610l polypolish	reverse	TTAGGGTTAGGGTTAGGGTTAGGGTTAGGGTTAGGGTTAGGGTTAGGGTTAGGGTTAGGGTTAGGGTTAGGGTTAGGGTTAGGGTTAGGGTTAGGGTTAG
ptg000611l polypolish	forward	TTAACCTACGTAACTTACCCTAACCCTAACCCTAACCCTAACCCTAACCCTAACCCTAACCCTAACCCTAACCCTAACCCTAACCCTAACCCTAACCCTA
ptg000622l polypolish	forward	CATTTTATGTACTCTAATCTATCTGCTAACCTTACCTTATTCCTAACCCTAACCCTAACCCTAACCCTAACCCTAACCCTAACCCTAACCCTAACCCTAA
ptg000634l polypolish	forward	TAACCCTAACCCTAGTATTACTCCCTAACCCTAACCCTAACCCTAACCCTAACCCTAACCCTAACCCTAACCCTAACCCTAACCCTAACCCTAACCCTAA
ptg000642l polypolish	forward	CTTTTATAGATATATTTCCTTAGTACTATAGGTCTTGCCCTATACTACCTAACCCTAACCCTAACCCTAACCCTAACCCTAACCCTAACCCTAACCCTAA
ptg000654l polypolish	forward	ATCTCCTTACTTCGTTCATGTAGCTTATTGCTCTTACGGTAACCCTAACCCTAACCCTAACCCTAACCCTAACCCTAACCCTAACCCTAACCCTAACCCT
ptg000668l polypolish	reverse	GGGTTAGGGTTAGGGTTAGGGTTAGGGTTAGGGTTAGGGTTAGGGTTAGGGTTAGGGTTAGGGTTAGGGTTAGGGTATAGGGTTAGGGAGCAATCTGACA
ptg000672l polypolish	forward	ATGTGTAACTCTGGTTAGATTACGTATTGCTCTAACCCTAACCCTAACCCTAACCCTAACCCTAACCCTAACCCTAACCCTAACCCTAACCCTAACCCTA
ptg000701l polypolish	forward	ATGTTTATGTTTACCCTAACTTCCTAACGCTAACGTGCCTTGCTCCCTAACCCTAACCCTAACCCTAACCCTAACCCTAACCCTAACCCTAACCCTAACC
ptg000710l polypolish	reverse	GGTTAGGGTTAGGGTTAGGGTTAGGTTAGGGTTAGGGTTAGGGTTAGGGTTAGGGTTAGGGTTAGGGTTAGGGTTAGGGTTAGGGTTAGGGTTAGGGTTA
ptg000714l polypolish	reverse	TTAGGGTTAGGGTTAGGGTTAGGGTTAGGGTTAGGGTTAGGGTTAGGGTTAGGGTTAGGGTTAGGGTTAGGGCATACGGTAACTGAAACGATTAGGGTTA
ptg000716l polypolish	forward	TAACCCTAACCCTAACCCTAACCCTAACCCTAACCCTAACCCTAACCCTAACCCTAACCCTAACCCTAACCCTAACCCTAACCCTAACCCTAACCCTAAC
ptg000727l polypolish	reverse	GTTAGGGTTAGGGTTAGGGTTAGGGTTAGGGTTAGGGTTAGGGTTAGGGTTAGGGTTAGGGTTAGGGTTAGGGTTAGGGTTAGGGTTAGGGTTAGGGTTA
ptg000734l polypolish	forward	ACCTTGGTAAGTCTTATATACTAGCCCTAACCCTAACCCTAACCCTAACCCTAACCCTAACCCTAACCCTAACCCTAACCCTAACCCTAACCCTAACCCT
ptg000742l polypolish	reverse	GGGTTAGGGTTAGGGTTAGGGTTAGGGTTAGGGTTAGGGTTAGGGTTAGGGTTAGGGTTAGGGTAGGAGCAATACTTAACCTAGTCAAGGTAGTATAGTA
ptg000764l polypolish	reverse	AGGGTTAGGGTTAGGGTTAGGGTTAGGGTTAGGGTTAGGGTTAGGGTTAGGGTTAGGGTTAGGGAATAGGCTACTAACTGAACCAAGTAGGTTACATAAC
ptg000770l polypolish	forward	CAAACCCTAACCCTAACCCTAACCCTAACCCTAACCCTAACCCTAACCCTAACCCTAACCCTAACCCTAACCCTAACCCTAACCCTAACCCTAACCCTAA
ptg000787l polypolish	forward	ATGTTTGTGCCACCTACTTGTAGTAACTTTATGCCTGACCATTGGTTCAGTTACGTATTCCTAACCCTAACCCTAACCCTAACCCTACCCTAACCCTAAC
ptg000804l polypolish	forward	GGTGTATTTTGTTTCTGGCAAAACTTGTAGCACAATATCTCAATGGTAACTAACAATATTGAATTAGCTATTGATCATTCAAGTGAGATTGCTTGCAACT
ptg000813l polypolish	reverse	TAGGAGTGTGAGTAGGTTAGGGTTAGGAGTAGTAGTAAGATTGATGGATGTGCACGAATGAGTACCATTTGCAATATGCTGCAAAGTAGAGCTAAAAACT
ptg000822l polypolish	forward	TGCCTACTTACTGGTTCAGTTACCCTAACGCTAACCCTAACCCTAACCCTAACCCTAACCCTAACCCTAACCCTAACCCTAACCCTAACCCTAACCCTAA
ptg000839l polypolish	forward	AGTTAGCCTACTGAACTATATATAACCTAACTTCGTAACCGTAACCCTAACCCTAACCCTAACCCTAACCCTAACCCTAACCCTAACCCTAACCCTAACC
ptg000841l polypolish	reverse	GGGTTAGGGTTAGGGTTAGGGTTAGGGTTAGGGTTAGGGTTAGGGTTAGGGTTAGGGTTAGGGTTAGGGTTAGGGTATAGGGTTAGGGTTAGGGTAGGGT
ptg000854l polypolish	reverse	TAATTTTAGGGTTAGGGTTAGAACTAGGAATTAGGGTTAACGTTAGGGTTCAGGTTTTAGGGTTAGAAGTAGTTTATGTACCTAAAGTCTAGGTATATAT
ptg000869l polypolish	forward	AGTTAGCCTTGGACCGATTACCCTAAACCCTAACCCTAATATACGTGTAGCCCTGGTAACCCTAACCCTAACCCTAACCCTAACCCTAACCCTAACCCTA
ptg000875l polypolish	reverse	AGGGTTAGGGTTAGGGTTAGGGTTAGGGTTAGGGTTAGGGTTAGGGTTAGGGTTAGGGTTAGCAATAGGTATGTAATCTAACCAAGTTAAGTAGGCATAA
ptg000884l polypolish	forward	TGTTATGTGTACCTACTACATTATTACGATGCCTATGTACCCTAACCCTTACGATTACCGTAACCCTAACCCTAACCCTAACCCTAACCCTAACCCTAAC
ptg000894l polypolish	forward	CTTAACCCACTTAGTCCCTAACCCTAACCCTAACCCTTCAATCCTAACCCTAACCCTAACCCTAACCCTAACCCTAACCCTAACCCTAACCCTAACCCTA
ptg000899l polypolish	forward	TCGTTGATTGACGTAATATTATATTAGCGCATATACCTAATTTTGCATACTTTGTGTCATGTTAACTAACATCACGTTTTAAATTGGACAGAATGTTCTC
ptg000904l polypolish	forward	TAACCCTAACCCTAACCCTAACCCTAACCCTAACCCTAACCCTAACCCTAACCCTAACCCTAACCCTAACCCTAACCCTAACCCTAACCCTAACCCTAAC
ptg000916l polypolish	forward	TGTTATCTGTTTGGGCTTATTGGTTGGCACGGGATCCTCGATTCATTTTGTGTTCATGATATCATAACTAACCAATGGGAGTTGGCCTCTACACATTACA
ptg000951l polypolish	reverse	TAGGGTTAGGGTTAGGGTTAGGGTTAGGGTTAGGGTTAGGGTTAGGGTTAGGGTTAGGGTTAGGGAGCAATACCTAACTGAACCAATAGTTGACATAACA
ptg000968l polypolish	forward	TTTAAATATTTTTTGTTCACCAAACTTTTCTCTTCTCGAAACTTTCTCGTCTTAACCCTAACTTGATCCAACCCCACACTATCATCTCGACTTAATCCCT
ptg000970l polypolish	forward	ATGCCTGCTACCCTACTACACTATTGCTCCCTAACCCTAACCCTAACCCTAACCCTAACCCTAACCCTAACCCTAACCCTAACCCTAACCCTAACCCTAA
ptg000983l polypolish	reverse	GTTAGGGTTAGGGTTAGGGTTAGGGTTAGGGTTAGGGTTAGGGTTAGGGTTAGGGTTAGGGTTAGGGTTAAGCACGTACTTAGTAAGGTTACATAATTAA
ptg000991l polypolish	forward	GTGTAAAAATCCTATTCCCTCGTAGTTAACTATATACCATAACCTAACCCTAACCCTAACCCTAGGGGCACCCTAACCCTAACCCTAACCCTAACCCTAA
ptg001025l polypolish	reverse	TTAGGGTTAGGGTTAGGGTTAGGGTTAGGGTTAGGGTTAGGGTTAGGGTTAGGGTAAGGGTTAGGGTTAGGGTTAGGGTTAGGGTTAGGACAATAGTATG
ptg001033l polypolish	forward	GTTAGTCCTCCCTTAACAGTTAACCCTAACCCTAACCCTAACCCTAACCCTAACCCTAACCCTAACCCTAACCCTAACCCTAACCCTAACCCTAACCCTA
ptg001034l polypolish	forward	ATGTATAACCAGGCTTCGGTTAGTTTACTATTCTCCTAACCTAGGTAACCCTAACCCTAACCCTAACCCTACCCTAACCCTAACCCTAACCCTAACCCTA
ptg001041l polypolish	reverse	TTAGGGTTAGGGTTAGGGTTAGGGTTAGGGTTAGGGTTAGGGTTAGGGTTAGGTTACTGTTAGTAGTTAGAATTAGGGTTAGGGTTATTAGCAATACTAG
ptg001057l polypolish	forward	ATCCTAGCCTTGACTTAGGCTGATCTTAATCCCTAACCCTAACCCTAACCCTAACCCTAACCCTAACCCTACCCTAATAACCCTAACCCTAACCCTAGAC
ptg001065l polypolish	forward	TACGTATTGCTCCTAACCCTAACCCTATCCCTAACCCTAACCCTAACCCTAACCCTAACCCTAACCCTAACCCTAACCCTAACCCTAACCCTAACCCTAA
ptg001087l polypolish	forward	ACTCATCGTATTGCTTACTATTTACCCTATTGCCCTAACCCTAACCCTAACCCTAACCCTAACCCTAACCCTAACCCTAACCCTAACCCTAACCCTAACC
ptg001094l polypolish	reverse	GGGTTAGGGTTAGGGTTAGGGTTAGGGTTAGGGTTAGGGTTAGGGTTAGGGTTAGGGTTAGGGTTAGAGCAATACGTAACTGAACGAGTAGAGGGCATAA
ptg001096l polypolish	reverse	AGGGTTAGGGTTAGGGTTAGGGTTAGGGTTAGGGTTAGGGTTAGGGTTAGGGTTAGGGTTAGGGTTAGGGTTAGCGTTAGGGTTAGGGTAAGGGTTAGCT
ptg001106l polypolish	forward	TTCTCGTATCAATTAGTATTGAGAACCCTAACCTAAGTTTAACCCTAACCTACTAACCCTAACCCTAACCCTAACCCTAACCCTAACCCTAACCCTAACC
ptg001113l polypolish	forward	ATTATTATGCTACCTACTTCAGACTTATTAGGATATTGCTACCCTAACCCTAATCCTAACCCTAACCCTAACCCTAACCCTAACCCTAACCCTAACCCTA
ptg001115l polypolish	reverse	TAGGGTTAGGGTTAGGGTTAGGGTTAGGGTTAGGGTTAGGGTTAGGGTTAGGGTTAGGGTTAGGGTAACTACGGTGAACATAAGCTAGATATAGTATATA
ptg001137l polypolish	reverse	AAGTTTTGTCGGAGGGTTTGTTCCACGTTTGAAAGTTACTGGGTTAAAGTTATTGGGTTAGGTTATGGTGGAGGGTTAAAGTTATTATGGTTAATATATA
ptg001143l polypolish	forward	TGTAACCTATTTTCACTTTACAATCTATTGTATCCCTAACCCTAACCCTAACCCTAACCCTAACCCTAACCCTAACCCTAACCCTAACCCTAACCCTAAC
ptg001157l polypolish	forward	TAACCCTAACCCTGCCCTAACCCTAACCCTAACCCTAACCCTAACCCTAACCCTAACCCTAACCCTAACCCTAACCCTAACCCTAACCCTAACCCTAACC
ptg001159l polypolish	forward	ACCCTAACCCTAACCCTAACCCTAACCCTAACCCTAACCCTAACCCTAACCCTAACCCTAACCCTAACCCTAACCCTAACCCTAACCCTAACCCTAACCC
ptg001172l polypolish	forward	AATTAGTATTGCTAACCCTAACCCTAACCCTAACCCTAACCCTAACCCTAACCCTAACCCTAACCCTAACCCTAACCCTAACCCTAACCCTAACCCTAAC
ptg001193l polypolish	reverse	GGGTTAGGGTTAGGGTTAGGGTTAGGGTTAGGGTTAGGGTTAGGGTTAGGGTTAGGGAGCAATACGTAAGTCTAGCGAGTAGGGTTAGGCATAAACATAG
ptg001196l polypolish	reverse	GGTTAGGGTTAGGGTTAGGGTTAGGGTTAGGGTTAGGGTTAGGGTTAGGGTTAGGGATAGGGCTAGGGTTAGGGTAGTTCGGGTTAGGGTTAGCATTAAA
ptg001255l polypolish	forward	GTTATGTAAGATAGATTCGCTCAGTTAGTGCTTTATGGTGCCTATACTTCGTTAGTTACGTATTGCCCTAACCCTAACCCTAACCCTAACCCTAACCCTA
ptg001264l polypolish	forward	TATATTAGATTAGCCCCTACTTGGTTCAGTCATGTATTGCTCTAACCCTAACCCTAACCCTAACCCTAACCCTAACCCTAACCCTAACCCTAACCCTAAC
ptg001270l polypolish	forward	AACTATTGCCTGGACTCTAATTGGCTCCCTAACGCTAACCCTAACCCTAACCCTAACCCTAACCCTAACCCTAACCCTAACCCTAACCCTAACCCTAACC
ptg001271l polypolish	forward	ATGTTATCTAGGGCTACTCGTTCAGTTACGTATTGCTCCTAACCCTAACCCTAACCCTAACCCTAACCCCTAACCCTAACCCTAACCCTAACCCTAACCC
ptg001272l polypolish	reverse	TAGGGTTAGGGTTAGGGTTAGGGTTAGGGTTAGGGTTAGGGTTAGGGTTAGGGTTAGGGTTAGGGTTAGGGTTAGGGTTAGGGTTAGGGTTAGGGTTAGG
ptg001295l polypolish	reverse	TTAGGGTTAGGGTTAGGGTTAGGGTTAGGGTTAGGGTTAGGGTTAGGGTTAGGGTTAGGGTTAGGGATTAGGGTTAGGGTTAGGGTTGGGATTAAGTGGC
ptg001320l polypolish	reverse	GTTAGGGTTAGGGTTAGGGTTAGGGTTAGGGTTAGGGTTAGGGTTAGGGTTAGGGTTAGGGTTAGAGTTGAGGGTTAGGTAGGGAGTATAGCTAGTATAA
ptg001322l polypolish	reverse	AGGGTTAGGGTTAGGGTTAGGGTTAGGGTTAGGGTTAGGGTTAGGGTTAGGGTTAGGGTTAGGGTTAGATGCAATACGTGCCTTACAAAGGAGGCCTACA
ptg001334l polypolish	reverse	TTAGGGTTAGGGTTAGGGTTAGGGTTAGGGTTAGGGTTAGGGTTAGGGTTAGGGTTAGTATCATGTAACGAACGACTAGAGAGGTTAGCAAATTTAAACA
ptg001347l polypolish	forward	GTTATGTGTAACTACTCAGACTTAGGTTGTGTCCTTACTACCCTAACCCTAACCCTAAACCCTAACCCTAACCCTAACCCTAACCCTAACCCTAACCCTA
ptg001351l polypolish	reverse	TTAGGGTTAGGGTTAGGGTTAGGGTTAGGGTTAGGGTTAGGGTTAGGGTTAGGGTTAGGGTTAGGGTTAGGGTTAGGGTTAGGGTTAGGGTTAGGGTTAG
ptg001354l polypolish	reverse	GAAGCCCAAGGACAGTATAGTTTATACATATCTAAAAGTCAATTACCGTTAGTTAGATCATTAGTAAAAGAATATATTCATCCTGAAATGATGTATAAGT
ptg001360l polypolish	forward	TATATTGACGTCCTAACCCTAACCCTAACCCTAACCCTAACCCTAACCCTAACCCTAACCCTAACCCTAACCCTAACCCTAACCCTAACCCTAACCCTAA
ptg001362l polypolish	forward	TACTCCCTATCAGTTACCGTAGCTCCCTAACTCCTAACATCTAACCCTAACCCTAACCCTAACCCTAACCCTAACCCTAACCCTAACCCTAACCCTAACC
ptg001363l polypolish	forward	CATATCATCTACTAGGTTCAGTCATGTGTACGGTAAGCTTAAGCTCCTAACCCTAACCCTAACCCTAACCCTAACCCTAACCCTAACCCTAACCCTAACC
ptg001385l polypolish	reverse	GGGTTAGGGTTAGGGTTAGGGTTAGGGTTAGGGTTAGGGTTAGGGTTAGGGTTAGGGTTAGGGTTAGGGTTAGGGTTAGGGTTAGGGTTAGGGTTAGGGT
ptg001406l polypolish	forward	AACCTAACCCTAGGACCGTATTGCTCCCTAACCCTAACCCTAACCCTAACCCTAACCCTAACCCTAACCCTAACCCTAACCCTAACCCTAAACCCTAACC
ptg001416l polypolish	forward	ACCTCATACCACTTATCAACCTTATTTACTGCCAGGAGCTCAGCTTCACCATGCCCTATAGTCCCTGCTACTACCCTAACCCTAACCCTAACCCTAACCC
ptg001445l polypolish	forward	CCTAACCCTAACCATAACCCTAACCCTAACCCTAACCCTAACCCTAACCCTAACCCTAACCCTAACCCTAACCCTAACCCTAACCCTAACCCTAACCCTA
ptg001463l polypolish	forward	TGTCCTGGTTCGTCAGTTACCTGTCTGATCCTAACCCTAACCCTAACCCTAACCCTAACCCTAACCCTAACCCTAACCCTAACCCTAACCCTAACCCTAA
ptg001472l polypolish	forward	TGTTTATGTCTGTCTGCTTTCGTTCAGTTACGTATTGCTAACCCTAACCCTAACCCTAACCCTAACCCTAACCCTAACCCTAACCCTAACCCTAACCCTA
ptg001476l polypolish	forward	GTAACCTTACTGGTTCTGCCCCCTAACCCTAACCCTAACCCTAACCCTAACCCTAACCCTAACCCTAACCCTAACCCTAACCCTAACCCTAACCCTAACC
ptg001509l polypolish	reverse	GGTTAGGGTTAGGGTTAGGGTTAGGGTTAGCTAATTAGGGTTAGGGTTAGGGTTGGTTAGGGAGCAATACCTAAATTAGAGACTAGGGTTAGGCATACAC
ptg001513l polypolish	forward	AGTAACCTACTCGTTCCCTAACCCTAACCCTAACCCTAACCCTAACCCTAACCCTAACCCTAACCCTAACCCTAACCCTAACCCCTAACCCTAACCCTAA
ptg001516l polypolish	forward	ATGTTACTGCTACCGTTCAGTTACGTATGTGCTAACCTAACTTCCTAACATTAACCCTAACCCTAACCCTAACCCTAACCCTAACCCTAACCCTAACCCT
ptg001543l polypolish	forward	TGGTAATCTGGCTAAGGATTACATACTAACCCTAACCCTAACCCTAACCCTAACCCTAACCCTAACCCTAATGGCCTAACCCTAACCCTAACCCTAACCC
ptg001556l polypolish	reverse	GGGTTAGGGTTAGGGTTAGGGTTAGGGTTAGGGTTAGGGTTAGGGTTAGGGTTAGGGTTAGGGTTAGGGTTAGGGTTAGGGTTAGGGTTAGGGTTAGGGT
ptg001586l polypolish	reverse	TAGGGTTAGGGTTAGGGTTAGGGTTAGGTTAGGGTTAGGGTTAGGGTTAGGGTTAGGGATAGGGTTAGGGTTAGGGTTAGGGTTAGGAGCAAACGTAGTG
ptg001588l polypolish	forward	CCCTAACCCTAACCCTAACCCTAACCCTAACCCTAACCCTAACCCTAACCCTAACCCTAACCCTAACCCTAACCCTAACCCTAACCCTAACCCTAACCCT
ptg001594l polypolish	reverse	GGTTAGGGTTAGGGTTAGGGTTAGGGTTAGGGTTAGGGTTAGGGTTAGGGTTAGGGTTAGGGTTAGGGTTAGGGTTAGGGTTAGGGTTAGGAGCAATACG
ptg001610l polypolish	forward	TAACCCTAACTCGTCAGGCACCGTAACTAAACCTAACCCTAACCCTAACCCTAACCCTAACCCTAACCCTAACCCTAACCCTAACCCTAACCCTAACCCT
ptg001613l polypolish	reverse	GTTAGGGTTAGGGTTAGGGTTAGGGTTAGGGTTAGGGTTAGGGTTAGGGTTAGGGTTAGGGTTAGGGTTAGGGTTAGGGTTAGGGTTAGGGCAATTATGG
ptg001683l polypolish	forward	TGTTTATGTTTAACTAAATGTCAAATACGTATTGTCTCCCTAACCCTAACCCTAACCCTAACCCTAACCCTAACCCTAACCCTAACCCTAACCCTAACCC
ptg001684l polypolish	forward	TGTTAACCCTAAGCCCTAGATCTCCTAACCCTAACCCTAACCCTAACCCTAACCCTAACCCTAACCCTAACCCTAACCCTAACCCTAACCCTAACCCTAA
ptg001707l polypolish	forward	ACCATCGTATGTCCCTAACCCTAACCCTAACCCTAACCCTAACCCTAACCCTAACCTAACCCTAACCCTAACCCTAACCCTAACCCTAACCCTAACCCTA
ptg001716l polypolish	forward	TGTTAGTAACATTACTTGTTAGATTTACATCTATACTACCCCTAACCCTAACCCTAACCCTAACCCTAACCCTAACCCTAACCCTAACCCTAACCCTAAC
ptg001741l polypolish	reverse	GGGTTAGGGTTAGGGTTAGGGTTAGGGTTAGGGTTAGGGTTAGGGTTAGGGTTAGGGTTAGGGTTAGGGTTAGGGTTAGGGTTAGGGTTAGGGTTAGGGT
ptg001771l polypolish	forward	TATGCTACCCCTAACCCTAAGTCTGGTATTGCTCCTAACCCTAACCCTAACCCTAACCCTAACCCTAACCCTAACCCTAACCCTAACCCTAACCCTAACC
ptg001779l polypolish	reverse	TTAGGGTTAGGGTTAGGGTTAGGGTTAGGGTTAGGGTTAGGGTTAGGGTTAGGGTTAGGGTTAGGGTTAGGGTTAGGGTTAGGGTTAGGGTTAGGGCTTG
ptg001805l polypolish	forward	ATCTGCCTACAAACTTCGTTCACTTACCGTATTGCTCCTAACCCTAACCCTAACCCTAACCCTAACCCTAACCCTAACCCTAACCCTAACCCTAACCCTA
ptg001832l polypolish	reverse	GTTAGGGTTAGGGTTAGGGTTAGGGTTAGGGTTAGGGTTAGGGTTAGGGTTAGGGTTAGGGTTAGGGTTAGGGTTAGGGTTAGGGTTAGGGCAATTAGAG
ptg001844l polypolish	reverse	GTTAGGGTTAGGGTTAGGGTTAGGGTTAGGGTTAGGGTTAGGGTTAGGGTTAGGGTTAGGGTTAGGGTTAGGGTTAGGGTTAGGGTTAGCGTAATAGGTA
ptg001863l polypolish	reverse	GGTTAGGGTTAGGGTTAGGGTTAGGGTTAGGGTTAGGGTTAGGGTTAGGGTTAGGGTTAGGGTTAGGGTTAGGGTTAGGGTTAGGGTTAGGGTTAGCGCT
ptg001936l polypolish	reverse	TAGGGTTAGGGTTAGGGTTAGGGTTAGGGTTAGGGTTAGGGTTAGGGTTAGGGTTAGGGTTAGGGAGCAATACGTAACTAGGAACCAGATACATGGCACA
ptg001945l polypolish	reverse	TAGGGTTAGGGTTAGGGTTAGGGTTAGGGTTAGGGTTAGGGTTAGGGTTAGGGTTAGGGTTAGTAATATCGTAACTGAACGAAGTAGACTAACATATAGA
ptg002078l polypolish	reverse	GGTTAGGGTTAGGGTTAGGGTTAGGGTTAGGGTTAGGGTTAGGGTTAGGGTTAGGGTTAGGGTAGTACTACATAGTCTAAGTCAGGCAGTACATAAACAT
ptg002099l polypolish	reverse	TTAGGGTTAGGGTTAGGGTTAGGGTTAGGGTTAGGGTTAGGGTTAGGGTTAGGGTTAGGGTTAGGGTTAGGGTTAGGGTTAGGGTTAGGGTTAGGGTTAA
ptg002104l polypolish	reverse	GGTTAGGGTTAGGGTTAGGGTTAGGGTTAGGGTTAGGGTTAGGGTTAGGGTTAGGGTTAGGGTTAGGGTTAGGGTAAACTAAGCCTTAGTAGGTTAGGCA
ptg002123l polypolish	forward	TAACCCTAACCCTAACCCTCACCCTAACCCTAACCCTAACCCTAACCCTAACCCTAACCCTAACCCTAACCCTAACCCTAACCCTAACCCTAACCCTAAC
ptg002132l polypolish	forward	GGCCGAGGGCTATATTGGAGTGAATAGGCTCGCCAAGTTTAATGTAAATAAATGTTCACCACATCACGTAACCTAACCCTAATAGTGCATGAATGGAAAT
ptg002138l polypolish	forward	TGTTTTGTGCCCCTAACCTAGCCCTAACCCTAACCCTAACCCTAACCCTAACCCTAACCCTAACCCTAACCCTAACCCTAACCCTAACCCTAACCCTAAC
ptg002142l polypolish	forward	AGTTTATGCCTACCTACTTGGTCTCACCTTACATATGCCTAACCCTAACCCTAACCCTAACCCTAACCCTAACCCTAACCCTAACCCTAACCCTAACCCT
ptg002181l polypolish	reverse	AGGGTTAGGGTTAGGGTTAGGGTTAGGGTTAGGGTTAGGGTTAGGGTTAGGGTTAGGGTTAGGGTTAGGGAGGGTTTAGGGTTAAAGCAGTACAGGATCA
ptg002184l polypolish	forward	ATGTACTGTACCTAGGGCTTAGTGGATTGTACCCTAACCCACGCAACCCTAACCCTAACCCTAACCCTTATGTACCCTAACCCTAACCCTAACCCTAACC
ptg002192l polypolish	forward	GTTATCATGTACTGATTAGGTTAGGAGCTAACCCTAACCCTAACCCTAACCCTAACCCTAACCCTAACCCTAACCCTAACCCTAACCCTAACCCTAACCC
ptg002203l polypolish	forward	TGTTAACCCTAACCCTAACCCTAACCCTAACCCTAACCCTAACCCTAACCCTAACCCTAACCCTAACCCTAACCCTAACCCTAACCCTAACCCTAACCCT
ptg002217l polypolish	reverse	GGGTTAGGGTTAGGGTTAGGGTTAGGGTTAGGGTTAGGGTTAGGGTTAGGGTTAGGGTTAGGGTTAGGGTTAGGGCAATCGTTATTTAGTCATGCAGCTA
ptg002232l polypolish	reverse	TTAGGGTTAGGGTTAGGGTTAGGGTTAGGGTTAGGGTTAGGGTTAGGGTTAGGGTTAGGGTTAGGGTTAGAGCAATACGGTTACTCAGAACCAGGTTACT
ptg002352l polypolish	forward	TATGCCTAAGGCTAAAATGCTGTTGCTAACCCTAACCCTAACCCTAACCCTAACCCTAACCCTAACCCTAACCCTAACCCTAACCCTAACCCTAACCCTA
ptg002357l polypolish	forward	ACCCTAACCTACTTCAGTCTGGTCTATGCTCCCTAACCCTAACCCTAACCCTAACCCTAACCCTAACCCTAACCCTAACCCTAACCCTAACCCTAACCCT
ptg002359l polypolish	reverse	AGGGTTAGGAGTTAGGGTTAGAATTACGATAGGTTGGGTATGATAGGGTTACAATGTATTTTTAGGAGCATACTTAATGAACAGTAGGTTACACAATAAT
ptg002422l polypolish	reverse	TAGGGTTAGGGTTAGGGTTAGGGTTAGGGTTAGGGTTAGGGTTAGGGTTAGGGTTAGGGTTAGGGTTAGGGTTAGGGTTAGGACGTTATGTTAACGGTTA
ptg002450l polypolish	forward	GCCTATTAACCCTAACCTAACCCTAACCCTAACCCTAACCCTAACCCTAACCCTAACCCTAACCCTAACCCTAACCCTAACCCTAACCCTAACCCTAACC
ptg002459l polypolish	forward	AGGGAGGGGTTAGGGGGGGGGGCCCCCTTAACTAACGCTCTCCCTAACCCTAACCCTAACCCTAACCCTAACCCTAACCCTAACCCTAACCCTAACCCTA
ptg002472l polypolish	forward	TAACATTGTTAAGATAAAATTATATGTGCTACCTAACCCTAACCCTAACCCTAACCCTAACCCTAACCCTAACCCTAACCCTAACCCTAACCCTAACCCT
ptg002499l polypolish	forward	TAACCCTAACCCTAACCCTAACCCTAACCCTAACCCTAACCCTAACCCTAACCCTAACCCTAACCCTAACCCTAACCCTAACCCTAACCCTAACCCTAAC
ptg002523l polypolish	forward	ATACCCTCTATACGTTCAGTCCACTAATTGCCCTAACCCTAACCCTAACCCTAACCCTAACCCTAACCCTAACCCTAACCCTAACCCTAACCCTAACCCT
ptg002575l polypolish	forward	ATGTCAAAAATTAGTATGTTTAATCCTGTATCCTATTTTCATAACATATATGCTCCCTAACCCTAACCCTAACCCTACCCTAACCCTAACCCTAACCCTA
ptg002607l polypolish	forward	GTTTATGTTAGCCTGACTTAGGTTCAGGTCTTGCTCCCTAACCCTAACCCTAACCCTAACCCTAACCCTAACCCTAACCCTAACCCTAACCCTAACCCTA
ptg002623l polypolish	forward	CTATTATTGCTAACCCTAACCCTAACCCTAACCCTAACCCTAACCCTAACCCTAACCCTAACCCTAACCCTAACCCTAACCCTAACCCTAACCCTAACCC
ptg002626l polypolish	forward	ATGCTATTTCAGACATTACGTCATGATCCTAACCCTGACCTAACCCTAACCTAACCCTAACCCTAACCCTAACCCTAACCCTAACCCTAACCCTAACCCT
ptg002651l polypolish	forward	TGTTATGTACTGTACTTCGTTCAGTTACGTATTGCTCCTAACCCTAACCCTAACCCTAACCCTAACCCTAACCCTAACCCTAACCCTAACCCTAACCCTA
ptg002675l polypolish	reverse	GTTAGGGTTAGGGTTAGGGTTAGGGTTAGGGTTAGGGTTAGGGTTAGGGTTAGGGTTAGGGTTAGCAAGGCACGTAACTGAACGAGTTAGGGCATAGGGT
ptg002709l polypolish	forward	CTTTCTTAGGTTATACTCTAGTATGGGGAACAATGAGTTTCTGGGGTGCAACGGTAATAACTAACCTATTATCAGCAATCCCAGTAATAGGAGGAGACTT
ptg002735l polypolish	reverse	GGGTTAGGGTTAGGGTTAGGGTTAGGGTTAGGGTTAGGGTTAGGGTTAGGGTTAGGGTTAGGGTTAGGGTTAGGGTTAGGGTTAGGGTTAGGGTTAGGGT
ptg002758l polypolish	forward	CCCTAACCCTAACCCTAACCCTAACCCTAACCCTAACCCTAACCCTAACCCTAACCCTAACCCTAACCCTAACCCTAACCCTAACCCTAACCCTAAACCC
ptg002823l polypolish	reverse	GGGTTAGGGTTAGGGTTAGGGTTAGGGTTAGGGTTAGGGTTAGGGTTAGGGTTAGGGTTAGGGTTAGGGTTAGGGTTAGGGTTAGGGTTAGGGTTAGGGT
ptg002971l polypolish	reverse	GGGTTAGGGTTAGGGTTAGGGTTAGGGTTAGGGTTAGGGTAGGGTTAGGGTAGGGTTAGGGTTAGGGTTAGGGTTAGGGTTAGGGTTAGGGTTAGGGTTA
ptg003011l polypolish	reverse	AGGGTTAGGGTTAGGGTTAGGGTTAGGGTTAGGGTTAGGGTTAGGGTTATGGGGTTAGGGTTAGGCACAGACTCTAACTGAACGAATAGAGGCACAACAT
ptg003028l polypolish	forward	GGTTACCCTAACCTTAACTACTATATTGCTCCCTAACCCTAACCCTAACCCTAACCCTAACCCTAACCCTAACCCTAACCCTAACCCTAACCCTAACCCT
ptg003082l polypolish	forward	CATCCCAATTGTCCCTAACCCTAACCCTAACCCTAACCCTAACCCTAACCCTAACCCTAACCCTAACCCTAACCCTAACCCTAACCCTAACCCTAACCCT
ptg003135l polypolish	reverse	TAGGGTTAGGGTTAGGGTTAGGGTTAGGGTTAGGGTTAGGGTTAGGGTTAGGGTTAGGGTTAGGGCAATACCTAGGGTGAAACCGTTAGGTTGTTAGCAT
ptg003217l polypolish	reverse	TTAGGGTTAGGGTTAGGGTTAGGGTTAGGGTTAGGGTTAGGGTTAGGGTTAGGGTTAGGGTTAGTAGGAATTAGGCTTAGGCTTAGGGATATAATTGGTT
ptg003305l polypolish	forward	ATTTTGCATACTTTGTGTCATGTTAACTAACATCACGTTTTAAATTGGACAGAATGTTCTCCGAAAAAAACTTTTGCCTGAATAAATTATCAAACGGCAA
ptg003410l polypolish	reverse	TTAGGGTTAGGGTTAGGGTTAGGGTTAGGGTTAGGGTTAGGGTTAGGGTTAGGGTTAGGGTTAGGGTTAGGGTTAGGGTTAGGGTTAGGGTTAGGGCTAC
ptg003438l polypolish	reverse	GTTAGGGTTAGGGTTAGGGTTAGGGTTAGGGTTAGGGTTAGGGTTAGGGTTAGGGTTAGGTAGTATATGGTAATCTAGGCCTTAGGGTTAGACATAAACA

Telomeres found: 217 (123 forward, 94 reverse)
