ptg000010l polypolish	forward	CTTTGCCCCTTGCTCTGTAACTCATACTGGTAGTTAGCTACCCTAACCCTAACCCTAACCCTAACCCTAACCCTAACCCTAACCCTAACCCTAACCCTAA
ptg000013l polypolish	reverse	TTAGGGTTAGGGTTAGGGTTAGGGTTAGGGTTAGGGTTAGGGTTAGGGTTAGGGTTAGGGAGTCAATACGGTAGACTGAACGAAGTACAGGTACATAACA
ptg000019l polypolish	forward	TTTTATGCTCTAACTACTAGACTCATCGTATCCTAAACAGCTAATAACTACCTAACACTAACCCTCCTAAGCCCTAACCCTAACCCTAACCCTAACCCTA
ptg000023l polypolish	forward	TTATGTGTGCCTGTTTCGTTCAGTTACGTATTGCTAACCCTAACCCTAACCCTAACCCTAACCCTAACCCTAACCCTAACCCTAACCCTAACCCTAACCC
ptg000026l polypolish	reverse	GTTAGGGTTAGGGTTAGGGTTAGGGTTAGGGTTAGGGTTAGGGTTAGGGTTAGGGTTAGCATTGATCTTAGCATTAGGGTTATTGATGAAGACCATGATT
ptg000029l polypolish	reverse	TTAGGGTTAGGGTTAGGGTTAGGGTTAGGGTTAGGGTTAGGGTTAGGGTTAGGGTTAGGGTTAGAGTTAGGGTTAGGGTTAGGGTTAGGGTAATACAGGC
ptg000032l polypolish	forward	TGTTATGTTTATATCTTACTTCAACGTTTCAGTTACGTATTGCTCCTAACCCTAACCCTAACCCTAACCCTAACCCTAACCCTAACCCTAACCCTAACCC
ptg000034l polypolish	reverse	GGTTAGGGTTAGGGTTAGGGTTAGGGTTAGGGTTAGGGTTAGGGTTAGGGTTAGGGTTAGGAGCAATACAATGTAACTGAACCAGTGGCAGAGGGCAAAA
ptg000036l polypolish	reverse	TTAGGGTTAGGGTTAGGGTTAGGGTTAGGGTTAGGGTTAGGGTTAGGGTTAGGGTTAGGGTTAGGGTTAGGAGCATTAGGCATGCTTAGTTTAGTGGTTA
ptg000039l polypolish	forward	ATTCTTATGCCCTGCCTATAATTGCCTGCCTAACCCTAACCCTAACCCTAACCCTAACCCTAACCCTAACCCTAACCCTAACCCTAACCCTAACCCTAAC
ptg000039l polypolish	reverse	TTAGGGTTAGGGTTAGGGTTAGGGTTAGGGTTAGGGTTAGGGTTAGGGTTAGTAGGTTACCTTCCTAGGTGAGCAGTACACTTTCTGACCAATAATCATA
ptg000042l polypolish	reverse	AGGGTTAGGGTTAGGGTTAGGGTTAGGGTTAGGGTTAGGGTTAGGGTTAGGTTAGGTTAGTACAGCAATACCTAACGAACTTCCAGGGTAGAGTTAAAAT
ptg000045l polypolish	forward	CCCTAACCCTAACCCTAACCCTAACCCTAACCCTAACCCTAACCCTAACCCTAACCCTAACCCTAACCCTAACCCTAACCCTAACCCTAACCCTAACCCT
ptg000045l polypolish	reverse	GTTAGGGTTAGGGTTAGGGTTAGGGTTAGGGTTAGGGTTAGGGTTAGGGGTTAGGGTTAGGGTTAGGGTTAGTAACAGGTTGGTTAGGTAGCAGCTACGA
ptg000046l polypolish	reverse	GTTAGGGTTAGGGTTAGGGTTAGGGTTAGGGTTAGGGTTAGGGTTCAGGGTTTAGGTAGCAATACCTAGAACTGAACCAATGGACATCTTTAAAAACTCA
ptg000051l polypolish	reverse	TAGGGTTAGGGTTAGGGTTAGGTTAGGGTTAGCTCTTAGGGTTAACATTAACTGTTTGGGTTAGGGTTAGGGTTAGGAACAATCGGTAGTTAGGGTGGTT
ptg000054l polypolish	forward	TTTTTTAACTACCATTCGTTCAGTTATGTATTGCTCCCTAACCCTAACCCTAACCCTAACCCTAACCCTAACCCTAACCCTAACCCTAACCCTAACCCTA
ptg000058l polypolish	forward	TTACCAATTGCTCCTAACCCTAACCCTAACCCTAACCCTAACCCTAACTAACCCTAATGCTTACGGTAACGTTATGTGCGTTATGTTACTCGCTCATTAC
ptg000058l polypolish	reverse	GGGTTAGGGTTAGGGTTAGGGTTAGGGTTAGGGTTAGGGTTAGGGTTAGGGTTAGGAGTACATATACGTAACTGAACGAAATAGATTATAGACATAGGCA
ptg000059l polypolish	forward	TGTTTAGGATGGGGAGTTAACCCTAACGTATTGCCTAACCCTAACCCTAATGCCTAACCCTAACCCTAACCCTAACCCTAACCCTAACCCTAACCCTAAC
ptg000060l polypolish	reverse	AGGGTTAGGGTTAGGGTTAGGGTTAGGGTTAGGGTTAGGGTTAGGGTTAGGTTAGTGGTTAGGGTTAGGGTTAGGGTTAGGTTGGGAGCTACGTGCAGTT
ptg000061l polypolish	reverse	TAGGGTTAGGGTTAGGGTTAGGGTTAGGGTTAGGGTTAGGGTTAGGGTTAGGAGTTAATAGGGTTAGGGTTAGGGGGGAAGTAGATACACATAAACATAA
ptg000062l polypolish	reverse	GGTTAGGGTTAGGGTTAGGGTTAGGGTTAGGGTTAGGGTTAGACTGAACCAAGTTAGGGTAGCACTTTATGTAAGCTGAACCAGTTAGGTTAGCTAAAAT
ptg000065l polypolish	reverse	GGGTTAGGGTTAGGGTTAGGGTTAGGGTTAGGGTTAGGGTTAGGGTTAGGGTTAGGGTTAGGGTTAGGGTTAGGGTTAGGGTTAGGGTTAGCAGCAATGA
ptg000067l polypolish	reverse	TAGGGTTAGGGTTAGGGTTAGGGTTAGGGTTAGGGTTAGGGTTAGGGTTAGGGTTAGGGTTAGGGTTAGGGAGCAGGACCTATAGGCTTAGGCTAGAGAT
ptg000070l polypolish	reverse	GGGTTAGGGTTAGGGTTAGGGTTAGGGTTAGGGTTAGGGTTAGGGTTAGGGTTAGGGTTAGGGTTAGTAGCAATACCTAACTGAACGAGTTAGGGCAATA
ptg000072l polypolish	forward	AGTGTTACCTTCCATTAGGCACTCATCAGTTGCCTGTACCCTAACTACTAACCCTATGCTCCTAACCCTACCCTAACCCTAACCCTAACCCTAACCCTAA
ptg000072l polypolish	reverse	GGGTTAGGGTTAGGGTTAGGGTTAGGGTTAGGGTTAGGGTTAGGGTTAGGAGTTAGGGTTAGGGTTAGGGTAGGTGTTACTTGTTACCGAGCAATGCATT
ptg000075l polypolish	reverse	AGGGTTAGGGTTAGGGTTAGGGTTAGGGTTAGGGTTAGGGTTAGGGTTAGAGTTAGGGTTAGGGTTAGGAGACATATGGTAACTGAACCATTTTATTGAC
ptg000076l polypolish	reverse	GGGTTAGGGTTAGGGTTAGGGTTAGGGTTAGGGTTAGGGTTAGCAATACATATGAGTTAGGGCTTAGCCTTAGGAGTTAATTAGGGAGCAATACTGGTAC
ptg000082l polypolish	reverse	GTTAGGGTTAGGGTTAGGGTTAGGGTTAGGGTTAGGGTAGGCGTTAGGAAGTTAGGGTTACATGAAGTATACTCGTTACGGTTAGTGTCTAGCCTAGGCT
ptg000088l polypolish	forward	TACCTCCTTTCAGTCAGGTATTGCTCCCTAAATCTAACCCTAACCCTAATTCCTATACTTGTTATACTACCCTAGGTATTTGACCTAACCCTAACCCTAA
ptg000091l polypolish	reverse	TAGGGTTAGGGTTAGGGTTAGGGTTAGGGTTAGGGTTAGGGTTAGGGTTAGGGTTAGGGTTAGGGTTAGGGTTAGGGTTAGGGTTAGGGTTCAATAGTAG
ptg000093l polypolish	forward	CCCTATACCCTACTGCTCATTAATGCCCTGTATTGCTAACCCTAACCCTAACCCTAACCCTAACCCTAACCCTAACCCTAACCCTAACCCTAACCCTAAC
ptg000094l polypolish	forward	CATAACCCTAGGGCTAATATACCGATTGCTCCCTAACCCTAACCCTAACCCTAACCCTAACCCTAACCCTAACCCTAACCCTAACCCTAACCCTAACCCT
ptg000097l polypolish	reverse	GTTAGGGTTAGGGTTAGGGTTAGGGTTAGGGTTAGGGTTAGGGTTAGGGTTAGGGTTAGGGTTAGGGTTAGGGCAATATACTAGGTTAGGGTACACATTA
ptg000098l polypolish	forward	AACGGTACGGCCCTAACCCTAACCCTAATGCCCTAACCCTAACCCTAACCCTAACCCTAACCCTAACCGTTCTAACCCTAACCCTAACCCTAACCCTAAC
ptg000099l polypolish	forward	TATGTTTATATATAATCTACTTCGTTCAGTTACGTATTGTTTACCCTTACCTTAACCCTAACTGCCTAACCCTAACCCTAACCCTAACCCTAACCCTAAC
ptg000099l polypolish	reverse	GGGTTAGGGTTAGGGTTAGGGTTAGGGTTAGGGTTAGGGTTAGGGTTAGGGTTAGGGTTAGGGTTAGGGTATAGGAAGTTAGGGTTAGGGTTAGTTACAT
ptg000101l polypolish	reverse	TAGGGTTAGGGTTAGGGTTAGGGTTAGGGTTAGTGGTTAGGGTTAGGGTAGCATAGACATTATTACGTTAGGAGCAATACTAACTGAACCAGTAGGTTAC
ptg000103l polypolish	forward	TAACCCTAACCCTAACCCTAACCCTAACCCTATTGCCCTAAACCCTAACCCTAACCCTAACCCTAACCCTAACCCTAACCCTAACCCTAACCCTAACCCT
ptg000103l polypolish	reverse	GTTAGGGTTAGGGTTAGGGTTAGGGTTAGGGTTAGGGTTAGGGTTAGGGTTAGGGTTAGGGTTAGGGTTAGGGTTAGGGTTAGGGTTAGGGTTAGGGTTA
ptg000104l polypolish	reverse	GGTTAGGGTTAGGGTTAGGGTTAGGGTTAGGGTTAGGGTTAGGGTTAGGGTTAGGGTTAGGGTTAGGGAGCAATACGTAACTGAACCAGTAGTATAACAA
ptg000105l polypolish	forward	CTATTACCCTAAATACCTATTGCTCCTCCTAGACCTGGTACCCTAACCCTATTACATAACCCTAACCCTAACCCTAACTGTAACCCTAACCCTAACCCTA
ptg000105l polypolish	reverse	AGGGTTAGGGTTAGGGTTAGGGTTAGGGTTAGGGTTAGGGTTAGGGTTAGGGTTAGGGTTAGGGTTAGGGTTAGGGTTACGTTACTGAGCAGATTACATG
ptg000106l polypolish	forward	TAACCCTAACCCTAACCCTAACCCTAACCCTAACCCTAACCCTAACCCTAACCCTAACCCTAACCCTAACCCTAACCCTAACCCTAACCCTAACCCTAAC
ptg000107l polypolish	reverse	AGGGTTAGGGTTAGGGTTAGGGTTAGGGTTAGGGTTAGGGTTAGGGTTAGGGTTAGGGTTAGGGTTAGAGCAGAAGACCTGAATCTGAGTTATAGGTTAA
ptg000109l polypolish	reverse	TTAGGGTTAGGGTTAGGGTTAGGGTTAGGGTTAGGGTTAGGGTTAGGGTTAGGAGCAGGGCTAACTGAACCAGCGTACAGCATAAAATACAGTAACATAA
ptg000113l polypolish	reverse	TAGGGTTAGGGTTAGGGTTAGGGTTAGGGTTAGGGTTAGGGTTAGGGTTAGAGTTAGGGTTAGGGTACTAGGGAACATAGAGCTATACTAACCAGTAGTA
ptg000114l polypolish	reverse	TTAGGGTTAGGGTTAGGGTTAGGGTTAGGGTTAGGAGTTAGGGTTAGGGTTAGGGTTAGGGTTAGGATAGTAATACCTAGAGTTAGGCTTAGGCATAAAC
ptg000117l polypolish	reverse	TTAGGGTTAGGGTTAGGGTTAGGGTTAGGGTTAGGGTTAGGGTTAGGGTTAGGGTTAGGGTTAGGGTAGGGTAGGGTAGCGTAGGGTTACGGCCTACTTG
ptg000120l polypolish	reverse	GGTTAGGGTTAGGGTTAGGGTTAGGGTTAGGGTTAGGGTTAGGGTTAGGGTTAGGGTTAGGGTTAGGGTTAGGGTTAGGGTTAGGGTTAGGGTTAGGGTT
ptg000121l polypolish	forward	TGTTTATGCTTTCCCTAACCCTACTCGTTCAGTTACGTATATATCCCTAACCCTGTACACTAACATCTGACTTGCCCTAACCCTAACCCTAACCCTAACC
ptg000121l polypolish	reverse	GTTAGGGTTAGGGTTAGGGTTAGGGTTAGGGTTAGGGTTAGGGTTAGGGTTAGGGTTAGGGTTAGGGTTAGGAGCAATACCTATAGTAGGTTACACTAAC
ptg000125l polypolish	reverse	GGGTTAGGGTTAGGGTTAGGGTTAGGGTTAGGGTTAGGGTTAGGGTTAGGGTTAGGGTTAGGGTTAGGGTTAGGGTAAGGTGTTAGGGTTAGCTACATTC
ptg000128l polypolish	reverse	AGGGTTAGGGTTAGGGTTAGGGTTAGGGTTAGGGTTAGGGTTAGGGTTAGGGTTAGGTTAGGGTTAGACAATACGGTAACTGATACGAGTAGCATACAAA
ptg000133l polypolish	reverse	GGTTAGGGTTAGGGTTAGGGTTAGGGTTAGGGTTAGGGTTAGGGTTAGGGTTAGGGTAGGCTAGCAATACGTAATGTACCAGGGTAGAGGTACATAAACT
ptg000134l polypolish	forward	ATGTCTCTCTGATCAGTATAGGTGCGGTGCTACCTAGGACCTGCTAACCTGCAGTTACCCTAACCCTAACCCTAACCCTAACCCTAACCCTAACCCTAAC
ptg000134l polypolish	reverse	AGGGTTAGGGTTAGGGTTAGGGTTAGGGTTAGGGTTAGGGTTAGGGTTAGGGTTAGGGTTAGGGTTAGGGACTGACAATATACCCAACCAAGTAGAGGAT
ptg000135l polypolish	forward	GATCCTACCTAGGTTAGGCTAATGTCCTCATACCAACAAGATCTAACCATAACCTAACTAACCCTAACCCTAACCCTCCTATTGTCCCTAACCCTAACCC
ptg000135l polypolish	reverse	GGTTAGGGTTAGGGTTAGGGTTAGGGTTAGGGTTAGGGTTAGGGTTAGGGTTAGGAGACTTCAATACGTAATCTAAGCTGGTCAAGCTCTGACAAAAACT
ptg000136l polypolish	forward	CCAATTGCTCTAACCCTTAACCCTAAGCCTATTCATTTAACCCTAACCCTAATCCCTAACCCTAACCCTAACCCTAACCCTAACCCTAACCCTAACCCTA
ptg000138l polypolish	forward	ATGTTTGCTAACCTACTCGGTAGTTGTACCCTAACCTAACCCTAACCCTAACCCTAACCCTAACCCTAACCCTAACCCTAACCCTAACCCTAACCCTAAC
ptg000138l polypolish	reverse	TAGGGTTAGGGTTAGGGTTAGGGTTAGGGTTAGGGTTAGGGTTAGGGTTAGGGTTAGGGTTAGGGTTAGCAATACCTAGAGTTACCAGTAGGGTTACAGT
ptg000139l polypolish	forward	ACATTACGTGTATTGTCCTACACCTAACCCTAACCCTAACCCTAACCCTAACCCTAACCCTAACCCTAACCCTAACCCTAACCCTAACCCTAACCCTAAC
ptg000139l polypolish	reverse	TAGGGTTAGGGTTAGGGTTAGGGTTAGGGTTAGGGTTAGGGTTAGGGTTAGGGTTAGGGTTAGGGTTAGGGTTAGGGTTAGGGTTAGGGTTAGGGTTAGG
ptg000146l polypolish	forward	CGATTATGCCTGTTTGCCTAACGATTCATTACCCTATGTGCCTCCTAACCCTAACCCTAACCCTAACCCTAACCCTAACCCTAACCCTAACCCTAACCCT
ptg000150l polypolish	reverse	AGGGTTAGGGTTAGGGTAAGGGTTAGGGTTAGGGTTAGGGTTACAGTACCAGGGTTAGGTTAGGGTTAGGGTTAGGGTTACCCTTTAAGCAATGTGCATG
ptg000152l polypolish	reverse	TTAGGGTTAGGGTTAGGGTTAGGGTTAGGGTTAGGGTTAGGGTTAGGGTTAGGGTTAGGGTTAGGGTTAGGGTTAGGGTAGTATTGATGATTAGGCATAC
ptg000153l polypolish	forward	TAAGGTGTAGCCTACTTGTTCCTTACTATCGTATCCCTAACCCTAACCCTAACCCTAACCCTAACCCTAACCCTAACCCTAACCCTAACCCTAACCCTAA
ptg000154l polypolish	forward	TAACCCTAACCCTAACCCTAATCCTAACCCTAACCCTAACCCTAACCCTAACCCTAACCCTAACCCTAACCCTAACCCTAACCCTAACCCTAACCCTAAC
ptg000154l polypolish	reverse	GGGTTAGGGTTAGGGTTAGGGTTAGGGTTAGGGTTAGGGTTAGGGTTAGGGTTAGGGTTAGGGTTAGGGAACCAATACGGACTAAGTCTGTACTAAGGGT
ptg000161l polypolish	forward	TGGTACTCTACTTTGAGTTAGTAACCCTGATTGCTCCCTAACCCTAACCCTAACCCTAACCCTAACCCTAGCCCTATGGTTAACCCTAACCTTACTACCC
ptg000161l polypolish	reverse	GGGTTAGGGTTAGGGTTAGGGTTAGGGTTAGGGTTAGGGTTAGGGTTAGGGTTAGGGTTAGGGTTAGGGAGCAATACGTAACTGAACGAAGTACAGGGCT
ptg000165l polypolish	reverse	GGGTTAGGGTTAGGGTTAGGGTTAGGGTTAGGGTTAGGGTTAGGGTTAGGGTTAGGGTTAGAACAATACGTAACTGAACGAAGTAAAGTAAGAATAAACT
ptg000166l polypolish	forward	TATGTCTAACTATTTTACTTCGTTCAGTTACGTATTGCTACCCTAACCCTAACCCTAACCCTAACCCTAACCCTAACCCTAACCCTAACCCTAACCCTAA
ptg000167l polypolish	forward	GCTTGCTTCGTCTCACTAGTATTGCTCCCTAACCCTAACCCTAAACCCTAACCCTAACCCTAACCCTAACCCTAACCCTAACCCTAACCCTAACCCTAAC
ptg000167l polypolish	reverse	AGGGTTAGGGTTAGGGTTAGGGTTAGGGTTAGGGTTAGGGTTAGGGTTAGGGTTAGGGTTAGGGACAATACCGTAACGAACGAAGCTAATCAAAATCAGT
ptg000169l polypolish	forward	TGTATACTACTTATCAGTTACCGTAGCCTCTACCCTAACCCTAACCCTAACCCTAACCCTAACCCTAACCCTAACCCTAACCCTAACCCTAACCCTAACC
ptg000171l polypolish	forward	ACCTATGTGTTACAGTTACCACGTATTGCTCCCTAACCCTAACCCTAACCCTAACCCTAACCCTAACCCTAACCCTAACCCTAACCCTAACCCTAACCCT
ptg000173l polypolish	forward	CCTATGCCCTAACCCTAAAGCCCTAACCCTAACCCTAACCCTAACCCTAACCCTAACCCTAACCCTAACCCTAACCCTAACCCTAACCCTAACCCTAACC
ptg000173l polypolish	reverse	TTAGGGTTAGGGTTAGGGTTAGGGTTAGGGTTAGGGTTAGGGTTAGGGTTAGGGTTAGGGTTAGGAGCAATACATGGTACTAGGGTTAGGGTACCCTAAC
ptg000174l polypolish	reverse	AGGGTTAGGGTTAGGGTTAGGGTTAGGGTTAGGGTTAGGGTTAGGGTTAGGGTTAGGGTTAGGGTTAGGAGCAATACGAGTACTGAACGAAGTACAGGGT
ptg000176l polypolish	forward	ATGTTTATGCCCTGTCTTGTTCAGTTACATTCTCCTAACCCTAACCCTAACCCTAACAACCCTAACCCTAACCATCCTAACCCTAACCCTAACCCTAACC
ptg000177l polypolish	reverse	TTAGGGTTAGGGTTAGGGTTAGGGTTAGGGTTAGGGTTAGGGTTAGGGTTAGGGTTAGGGTTAGGGTTAGGGTTAGGGTTAGGGTTAGGGTTAGGGTTAG
ptg000178l polypolish	forward	CCCTAACCCTAACCCTAACCCTAACCCTAACCCTAACCCTAACCCTAACCCTAACCCTAACCCTAACCCTAACCCTAACCCTAACCCTAACCCTAACCCT
ptg000178l polypolish	reverse	TTAGGGTTAGGGTTAGGGTTAGGGTTAGGGTTAGGGTTAGGGTTAGGGTTAGGGTTAGGGTTAGGGTTAGGGTTAGGGTTAGGGTTAGGGTTAGGGTTAG
ptg000179l polypolish	reverse	GTTAGGGTTAGGGTTAGGGTTAGGGTTAGGGTTAGGGTTAGGGTTAGGGTTAGGGTTAGGGTTAGGAGCCGATACCTAACTAGAGCCAATAGGTTACATA
ptg000180l polypolish	forward	TTGACATCGTTAGTTACGTATTGCTCGGAACCCTAATCCCTAACCCTAACCCTAACCCTAACCCTAACCCTAACCCTAGGTCCTAACCCTAACCCTAACC
ptg000180l polypolish	reverse	TTAGGGTTAGGGTTAGGGTTAGGGTTAGGGTTAGGGTTAGGGTTAGCGTTAGGGTTAGGGTTAGGGAGACTAAGATACCTAGTTGAACCAAGTCAGGATA
ptg000181l polypolish	forward	CTAACCCTAACCCTAACCTCTAACCCTAACCCTAACCCTAACCCTAACCCTAACCCTAACCCTAACCCTAACCCTAACCCTAACCCTAACCCTAACCCTA
ptg000186l polypolish	forward	ATTCTCTATTCGCTATGTCTAGGTGACTGCTCCTAACCCTATGACCCTAACCCTAACCCTAACCCTAACCCTAACCCTAACCCTAACCCTAACCCTAACC
ptg000188l polypolish	forward	TGTTACCCTAACTCTACTAGTATTGCTCGTAACCCTACCCTAACCCTACATACCTAACCCTAACCCTAACCCTAACCCTAACCCTAACCCTAACCCTAAC
ptg000188l polypolish	reverse	AGGGTTAGGGTTAGGGTTAGGGTTAGGGTTAGGGTTAGGGTTAGGGTTAGGAACGAAGGCCTAAACTTAGGGTTAGGGTTAGGGTTAGCAGCAATTCATA
ptg000193l polypolish	forward	TTTTATGGTATTCTATTTCGTTCACTTACCGTTATTACTCCTAACCCTAACCCTAACCCTAACCCTAACCCTAACCCTAACCCTAACCCTAACCCTAACC
ptg000196l polypolish	forward	GTTTATATACTATACACCTCGTAGATTACTGTATCTGCTAGGCCTAACCCTAACCCTAACCCTAACCCTAACCCTAACCCTAACCCTAACCCTAACCCTA
ptg000207l polypolish	forward	TTATGTCTATTGCTGCTAAACTCCCTATCCTGTTCCCTAACCCTAACCCTAACCCTAACCCTAACCCTAACCCTAACCCTAACCCTAACCCTAACCCTAA
ptg000209l polypolish	reverse	GGGTTAGGGTTAGGGTTAGGGTTAGGGTTAGGGTTAGGGTTTAGGGTTAGGGTTAGGGTTAGAGCAATACGTAACTGACAGAGAAGTAACAGGACATAAA
ptg000210l polypolish	forward	ACCGATTGCTCCCTAACCCTAACCCAACCCTACTAACCCTAACCTAACTCTAAGTTTCGACCCTAACCCTAACCCTGAAGATTGAACCCTACCACCCTAA
ptg000214l polypolish	reverse	GGGTTAGGGTTAGGGTTAGGGTTAGGGTTAGGGTTAGGGTTAGGGTTAGGGTTAGGGTTAGGGTTAGGAATACGGTAACTGACCAGATAGTTACATAAAC
ptg000215l polypolish	forward	TCAACCAATTCCGGTATTCTAATAACCATTAATTGTAACCCTAAGGTTAACCCTAACCCTAACTCTAACTTCGTTCAGTTAACGTATTGCTCCCTAACCC
ptg000224l polypolish	reverse	TTAGGGTTAGGGTTAGGGTTAGGGTTAGGGTTAGGGTTAGGGTTAGGGTTAGGGTTAGGGTTAGGAGCAATACGTAAGTGAACGACTTACAGATGCAAAA
ptg000226l polypolish	forward	TGTTTGGCCTAACCTATGGTTCAGATTCACTGTATTGTTCAGTTACGCATTGCGTCTAACCCTAACCCTAACCCTAACCCTAACCCTAACCCTAACCCTA
ptg000226l polypolish	reverse	AGGGTTAGGGTTAGGGTTAGGGTTAGGGTTAGGGTTAGGGTTAGGGTTAGGGTTAGGGTTAGGGTTAGGGAGCAATACGTAACTGAACCACTAGGTTACA
ptg000228l polypolish	forward	GTATGTTTATTATGTAACCCTAAGCCCTAGGCATGTACCCTAACCCTAACCCTAACCCTAACCCTAACCCTAACCCTAACCCTAACCCTAACCCTAACCC
ptg000231l polypolish	forward	TGTTACTGTACTCGTTCCCTTACCGTAACCCTAACCCTAACCCTAACCCTAACCCTAACCCTAACCCTAACCCTAACCCTAACCCTAACCCTAACCCTAA
ptg000231l polypolish	reverse	GGGTTAGGGTTAGGGTTAGGGTTAGGGTTAGGGTTAGGGTTAGGGTTAGGGTTAGGGTTAGGGTTAGGGCTATGGTTACTAGGAGTCAGATGGTAGCTTA
ptg000232l polypolish	reverse	AGGGTTAGGGTTAGGGTTAGGGTTAGGGTTAGGGTTAGGGTTAGGGTTAGGGTTAGGGTTAGGGTTAAGCAATACGGTAACTAGGAACGGTACGTTACAC
ptg000234l polypolish	forward	CTATGTTTCTGTAACCCTGGACTTTTGCAGTTACATATGCTGTGTAACCCTACGTTCAGTAACTCCTAACCCCTAACCCTAACCCTAACCCTAACCCTAA
ptg000234l polypolish	reverse	TAGGGTTAGGGTTAGGGTTAGGGTTAGGGTTAGGGTTAGGGTTAGGGTTAGGGTTAGGGTTAGGGTTAGGGTTATGGTATTGATCCAGTAGCTTAGGCAT
ptg000239l polypolish	forward	CCTAACCCTAACCCTAACCCTAACCCTAACCCTAACCCTAACCCTAACCCTAACCCTAACCCTAACCCTAACCCTAACCCTAACCCTAACCCTAACCCTA
ptg000240l polypolish	forward	TATCCATTTACTGGTCAGTAGCTCAGCTGTTCCCTACCTTAACTCTAACCCTAACCGTAACCCTAACCCTAACCCTAACCCTAACCCTAACCCTAACCCT
ptg000241l polypolish	reverse	GGGTTAGGGTTAGGGTTAGGGTTAGGGTAAGGGACTAGGGTTAGGGTTAGGGTTAGTGTTAGGGTTAGAGTGGGTTAGGCATATGCTATGAGGATTTGCC
ptg000246l polypolish	reverse	TTAGGGACATTATCATCTAGCAAAGGCTTAGGGTGTGGGTTAGGGTTACCCCCTTAGAACCCTAGGGTTAGGGTTAGGGTTAGGGTAGGGGGACGTCTAG
ptg000247l polypolish	forward	TATGATGTTTATGTCTAGACCTACTCGTTAGCTTATATTGCTAACCTAACCCTAACCCTAACCCTAACCCTAACCCTAACCCTAACCCTAACCCTAACCC
ptg000247l polypolish	reverse	GGGTTAGGGTTAGGGTTAGGGTTAGGGTAGTTATGGTTACGGTGCACTGCTTTCAGAATTAGGGTTAGAGCATAGATGTAATCTAGCAGGACAGTACACA
ptg000251l polypolish	forward	TTATGTCACTTGGCACTTCGTTCAGTTACGTATTGCTTTCCTAACCCTAGTTCCCTTGCTCCCTAACCCTAACCCTAACCCTAACCCTAACCCTAACCCT
ptg000257l polypolish	reverse	AGGGTTAGGGTTAGGGTTAGGGTAGTAGGGTCTAAGGTTAGGGTTAGGGTTAGGGTTAGGGCTTTCAGGGCAGCAATACCTAACCCTAAGTTAAGTAAGA
ptg000259l polypolish	reverse	GGTTAGGGTTAGGGTTAGGGTTAGGGTTAGGGTTAGGGTTAGGGTTAGGGTTAGGGTTAGGGTTAGGGTAAGGACGTAACTGAACCAGTAGGGTTACCAG
ptg000260l polypolish	forward	AAGCAGGCCCTAATGCCCTAACCCTAACTCGTAACCCTAACCCTAACCCTAACCCTAACCCTAACCCTAACCCTAACCCTAACCCTAACCCTAACCCTAA
ptg000260l polypolish	reverse	TTAGGGTTAGGGTTAGGGTTAGGGTTAGGGTTAGGGTTAGGGTTAGGGTTAGGTTAGGGTTAGGGTTAGTGGATAGCGTTAGCGTACAGTAGGTTATCTC
ptg000262l polypolish	forward	TGTGTACTCGTTCTATGTTACGTATTGCTCTGAAATGCTAACCTGTCTAACGTTCCTAACCCTAACCCTATCCCTAACCCTAACCCTAACCCTAACCCTA
ptg000265l polypolish	forward	GCTTTGTTCTGTGTCCTCTACTTGGTTCAGTTACGTCCTTGCTCCCTAACCCTAACCCTAACCCTAACCCTAACCCTAACCCTAACCCTAACCCTAACCC
ptg000265l polypolish	reverse	GGGTTAGGGTTAGGGTTAGGGTTAGGGTTAGGGTTAGGGTTAGGGTTAGGGTTAGGGTTAGGGTTAGGTCAATACATAAGCTAGGAGTAGTGGCTCACAA
ptg000270l polypolish	forward	TTTATTCATGCACTTCGTCAGTTACCCTATTGCTCCCTAACCCTAACCCTAACCCTAACCCTAACCCTAACCCTAACCCTAACCCTAACCCTAACCCTAA
ptg000270l polypolish	reverse	AGGGTTAGGGTTAGGGTTAGGGTTAGGGTTAGGGTTAGGGTTAGGGTTAGGGTTAGGGTTACACAGTTAGGGTAGACTAGCTGAGTTTAGGTTGGCATAC
ptg000271l polypolish	reverse	GGTTAGGGTTAGGGTTAGGGTTAGGGTTAGGGTTAGGGTTAGGGTTAGGAGGGTTAGCGTAAAGCAAGTACACTGATTTATGGTTCAACGATCTATACAT
ptg000276l polypolish	reverse	TTAGGGTTAGGGTTAGGGTTAGGGTTAGGGTTAGGGTTAGGGTTAGGGTTAGGGTTAGGGTTAGGGTTAGGGTTAGAATACTAACTGAACCAAGGTCATA
ptg000278l polypolish	reverse	TAGGGTTAGGGTTAGGGTTAGGGTTAGGGTTAGGGTTAGGGTTACTGGTATAGAGTTAGGGTTAGGGTTAGGGTTAGGGAGTATATGACTGAACCGACAT
ptg000279l polypolish	forward	AACCTACTGTTCATTATATTTCTACCCTAACCCTAACCCTAACCCTAACCCTAACCCTAACCCTAACCCTAACCCTAACCCTAACCCTAACCCTAACCCT
ptg000280l polypolish	reverse	AGGGTTAGGGTTAGGGTTAGGGTTAGGGTTAGGGTTAGGGTTAGGGTTAGGGTTAGGGTTAGGGTTAGGGAGCAAGACTAACTGAACGAAGTAGTAGACA
ptg000282l polypolish	reverse	TTAGGGTTAGGGTTAGGGTTAGGGTTAGTTAGGTTAGGGTTAGGGTTAGGTTTAGGGTTAAAGTTATCCATAGAGAGTTCAGGGAATTTGGGACCTAGAC
ptg000289l polypolish	forward	CCCTAACCCTAACCCTAACCCTAACCCTAACCCTAACCCTAACCCTAACCCTAACCCTAACCCTAACCCTAACCCTAACCCTAACCCTAACCCTAACCCT
ptg000295l polypolish	forward	TTATGATCCTTGATCAGTTCACCGTATTGCCCTAACCCTAACCCTAACCCTAACCCTAACCCTAACCCTAACCCTAACCCTAACCCTAACCCTAACCCTA
ptg000297l polypolish	forward	ATCTGTAACCCTCGTTCAGTTACGTCTGGCTTAACCCTTAACCCTAACCCTAACCCTAACCCTAACCCTAACCCTAACCCTAACCCTAACCCTAACCCTA
ptg000298l polypolish	reverse	TTAGGGTTAGGGTTAGGGTTAGGGTTAGGGTTAGGGTTAGGGTTAGGGTTAGGGTTAGGGTTAGGGTTAGGGTTAGGGTTAGGGTTAGGAGAATACGTAG
ptg000299l polypolish	reverse	GGTTAGGGTTAGGGTTAGGGTTAGGGTTAGGGTTAGGGTTAGGGTTAGGGTTAGGGTTAGGGTTAAGGGTTAGGGCAACTTAGGTTAGGGAGCTTGGTGG
ptg000304l polypolish	forward	GCATCATACTGGCACTAGGCATTGCTACCCTAACCCTAACCCTAACCCTAACCCTAACCCTAACCCTAACCCTAACCCTAACCCTAACCCTAACCCTAAC
ptg000307l polypolish	forward	TGTGTATGCTACCTAAGGCTCGGATTACATATACTACCCTAACCCTAACCCTAACCCTAACCCTAACCCTAACCCTAATTCCCTAACCCTAACCCCTAAC
ptg000308l polypolish	forward	GTTGTGTATTCTACCTGAGCTCAGTTACGTATTGCATCCCTAACCCTAACCCTAACCCTAACCCTAACCCTAACCCTAACCCTAACCCTAACCCTAACCC
ptg000309l polypolish	reverse	GTTAGGGTTAGGGTTAGGGTTAGGGTTAGGGTTAGGGTTAGGGTTAGGGTTAGGGTTAGGGTTAGGAGTATAGGGTAACTGAACGAAGTACAGTGAACAT
ptg000310l polypolish	reverse	GGGTTAGGGTTAGGGTTAGGGTTAGGGTTAGGGTTAGGGTTAGGGTTAGGGTTAGGGTTAGGGAGCAATACGTAACTGAACCAGCATAACAGGCAAAACA
ptg000314l polypolish	reverse	GGTTAGGGTTAGGGTTAGGGTTAGGGTTAGGGTTAGGGTTAGGGTTAGGGTTAGGGTTAGGGTTAGGGTTAGGGAGCAATACGTAACTGATAGTGTTAGG
ptg000317l polypolish	reverse	TTAGGGTTAGGGTTAGGGTTAGGGTTAGGGTTAGGGTTAGGGTTAGGGTTAGGGTTAGGGTTAGCAATACGTAACATGAAACCAGAGTATGGTTACACCT
ptg000319l polypolish	forward	GACGAATTGCCCTATCGGCTAACCCTACAGCCCCTAAGCCTAACCCTAACAGTTACCGTATTGCTCCTAACCCTAACCCTAACCCTAACCCTAACCCTAA
ptg000324l polypolish	forward	GTACAAAAATTGCTCCTTAGTTCATCCTAGACAGCAGGACGGCCTAACCCTAACCCTAACCCTAACCCTAACCCTAACCCTAACCCTAACCCTAACCCTA
ptg000329l polypolish	reverse	TAGGGTTAGGGTTAGGGTTAGGGTTAGGGTTAGGGTTAGGGTTAGGGTTAGGGTTAGGGTTAGGGTTAGGGTTAGGAGTTAGGGTTAGGGTTAGGGTTAG
ptg000330l polypolish	reverse	GTTAGGGTTAGGGTTAGGGTTAGGGTTAGGGTTAGGGTTAGGGTTAGGGTTAGGGTTAGGGTTAGGGAACAGGGCACTAAACTTAGTCTTAGGTTAGGAT
ptg000331l polypolish	reverse	GGTTAGGGTTAGGGTTAGGGTTAGGGTTAGGGTTAGGGTTAGGGTTAGGGTTAGGGTTAGCAATAGGGAGCAATACGTAGACTGAACTAATAGAGGGCAT
ptg000333l polypolish	forward	TATTTACTGGTTCGTTACATATACTACCCTAACCCTAACCCTAACCCTAACCTAACCCTAACCCTAACCCTAACCTATACTCCTAACCCTAACCCTAACC
ptg000334l polypolish	reverse	TTAGGGTTAGGGTTAGGGTTAGGGTTAGGGTTAGGGTTAGGGTTAGGGTTAGGGTTAGGGTTAGGGTTAGGAGCAATACGTAACTAACCAATAGGCTATT
ptg000336l polypolish	reverse	GGTTAGGGTTAGGGTTAGGGTTAGGGTTAGGGTTAGGGTTAGGGTTAGGGTTAGGGTTAGGGTTACGGATGCAAGACTAACTTAAGCGAGTAGGTTACAT
ptg000346l polypolish	forward	CTCTATGTTATTGTAACTTCCTGGACTCCTAGGCCCTAACCCTAACCCTAACCCTAACCCTAACCCTAACCCTAACCCTAACCCTAACCCTAACCCTAAC
ptg000347l polypolish	forward	CATTCTTGAATGTATTCTTCTCTTTATTAATCTACTTAGCTCGGTTACCGTATAGCTCTAACCCTAACCCTAACCCTAACCCTAACCCTAACCCTAACCC
ptg000347l polypolish	reverse	GGGTTAGGGTTAGGGTTAGGGTTAGGGTTAGGGTTAGGGTTAGGGTTAGGTAATAGGTTAGGCTACACTAAACTAACGAACTCAAGGTACTAACATAAGA
ptg000353l polypolish	reverse	TTAGGGTTAGGGTTAGGGTTAGGGTTAGGGTTAGGGTTAGGGTTAGGGTTAGGGTTAGAACGAAGTTACGTCTTCAGTGGCTAGGCAGTAGAACATAAGA
ptg000354l polypolish	forward	AGTGTACTTGGTTCAGTTACATATTGCTACCTAACCCTAACCCTAACCCTAACCCTAACCCTAACCCTAACCCTAACCCTAACCCTAACCCTAACCCTAA
ptg000354l polypolish	reverse	GTTAGGGTTAGGGTTAGGGTTAGGGTTAGGTTAGGGTTCAGGGATTAGGGTTAGGGTTAGGGTTAGATCAATGCGGGCCCTGATCGAAGCTGTAGAGTTA
ptg000357l polypolish	forward	AACGCATTGCTCCTAACCCATTAACCCTAACCCTAACCCTAACCCTAACCCTAACCCTAACCCTAACCCTAACCCTAACCCTAACCCTAACCCTAACCCT
ptg000357l polypolish	reverse	GGGTTAGGGTTAGGGTTAGGGTTAGGGTTAGGGTTAGGGTTAGGGTTAGGGTTAGGGTTAGGGTTAGGGTTAGGGTTAGGGTTAGGGTTAGGAATACGTA
ptg000359l polypolish	reverse	TTAGTACTAGTGTTATAGTATTGAGTATCAGCTGCCAACTTAGTCGAGTCAGGAGTTAGTTAGCAATACGTAACTGAACGAAGTAACTAACATAACATAA
ptg000361l polypolish	forward	ATGTCTACCCTAAGACTTAGGGTTAGTCTATCTACTCCCTAACCCTAACCCTAACCCTAACCCTAACCCTAACCCTAACCCTAACCCTAACCCTAACCCT
ptg000370l polypolish	reverse	AGGGTTAGGGTTAGGGTTAGGGTTAGGGTTAGGGTTAGGGTTAGGGTTAGGGTTAGGGTTAGGGTTAGGGTTAGGGTTAGGGTTAGGAGCATTGGTGGTC
ptg000371l polypolish	reverse	GTTAGGGTTAGGGTTAGGGTTAGGGTTAGGGTTAGGGTTAGGGTTAGGGTTAGGGTTAGGGTTAGGGTTAGGGAGCAATACCTAATGTAATGAGATTCAC
ptg000372l polypolish	forward	TGTAGTGGCCTCATAGTACTATTGTCCCTAACCCTAACCCTAACCCTAACCCTAACCCTAATCCCTAACCCTGAACCCTAACCCTAACCCTAACCCTAAC
ptg000372l polypolish	reverse	GTTAGGGTTAGGGTTAGGGTTAGGGTTAGGGTTAGGGTTAGGGTTAGGGTTAGGGTTAGGGTTAGGGTAGCTGAACGAGTCTAGACTTAGGGTTAATCTA
ptg000373l polypolish	reverse	TTAGGGTTAGGGTTAGGGTTAGGGTTAGGGTTAGGGTTAGGGTTAGGGTTAGGGTTAGGGTTAGGGTTAGGAGCAATAGGGTTACTGTTCCAAGGCTAGA
ptg000376l polypolish	forward	TATCTGACCCTAACATCGTTCATTGTCTAACCCTAACCCTAACCCTAACCCTAACCCTAACCCTAACCCTAACCCTAACCCTAACCCTAACCCTAACCCT
ptg000384l polypolish	forward	TGTTGCTATGTTTGCCCTAATTCCTGAGTTCCGCTTACCCTATTGCTCCCTAACCCTAACCCTAACCCTAACCCTAACCCTAACCCTAACCCTAACCCTA
ptg000384l polypolish	reverse	TTAGGGTTAGGGTTAGGGTTAGGGTTAGGGTTAGGGTTAGGGTTAGGGTTAGGGAGCAATAGGGTAATTAGTACGTTAGGGTTATACCATAAGGCACATA
ptg000386l polypolish	reverse	TAGGGTTAGGGTTAGGGTTAGGGTTAGGGTTAGGGTTAGGGTTAGGGTTAGGGTTAGGATAACTGAACCAAGGCAGTCATAGGGTTACCGTTAGGGCTAG
ptg000394l polypolish	forward	ATGCCTCTACTTGATTGATCGTACATACTATGTCTCCTAACCCTAACCCTAACCCTAACCCTAACCCTAACCCTAACCCTAACCCTAACCCTAACCCTAA
ptg000396l polypolish	forward	ATAACCTACTCGTAGGTACGTGACTTTTCTAACCCTAACCCTAACCCTAACCCTAACCCTAACCCTAACCCTAACCCTAACCCTAACCCTAACCCTAACC
ptg000397l polypolish	reverse	GGTTAGGGTTAGGGTTAGGGTTAGGGTTAGGGTTAGGGTTAGGGTTACAGGGTTAGGGTTAGGGTTAGGAGCAATAATGTACTGACGAAGTAAATAGCAA
ptg000399l polypolish	reverse	GGGTTAGGGTTAGGGTTAGGGTTAGGGTTAGGGTTAGGGTTAGGGTTAGGGTTAGGGTTAGGGTTAGGGAGACATAACGGATGAACATAGGGTTACTGAT
ptg000405l polypolish	forward	ATGTTCCTATGTAACTCTACTGGTTCAGTTAGGTATTGCTTGCTCCTAACCCTAACCCTAACCCTAACCCTAACCCTAACCTTAACCCTAACCCTATTGC
ptg000405l polypolish	reverse	TTAGGGTTAGGGTTAGGGTTAGGGTTAGGGTTAGGGGTTAGGGTTAGGGTTAGGGTTAGGTTAGCAATACGTAACTAGAACCAAGTAGGAACATAAACAT
ptg000408l polypolish	reverse	TTAGGGTTAGGGTTAGGGTTAGGGTTAGGGTTAGGGTTAGGGTTAGAGTTAGGGTTAGGGTTAGGGCAATACGTACTGTTACCCAGAGGCTAAGTAAATA
ptg000414l polypolish	forward	TACGTAGTGCTCCTACCCTAAGACTAACCCTAACCCTAACGCTAACTAATCCTAACCCTAACCCTAACCCTAACCCTAACCCTATGTACCCTAACCCTAA
ptg000414l polypolish	reverse	AGGGTTAGGGTTAGGGTTAGGGTTAGGGTTAGGGTTAGGGTTAGGGTTAGGGAGCTAGGCTTAGGGTTAGGGTTAGGAGTAGAGGAGAGAGAGAGAGAGA
ptg000416l polypolish	reverse	TTAGGGTTAGGGTTAGGGTTAGGGTTAGGGTTAGGGTTAGGGTTAGGGTTATGGTTAGGGTTAGGGTCTGGGTTGGGACCTTGGCAGCGAGATTACGGTG
ptg000425l polypolish	reverse	GGTTAGGGTTAGGGTTAGGGTTAGGGTTAGGGTTGGGGACAGGGTTGGGGACTAGGTAGTATGAATACTAACTGAACCAAGTAGAATACGCTGGGCATAA
ptg000428l polypolish	reverse	GGTTAGGGTTAGGGTTAGGGTTAGGGTTAGGGTAGGGTAATAGGGTCCTAGGGTTAGGGTTAGGGTTAGGAGCTATACGTAATGTTAGGGTTAGGGTACA
ptg000432l polypolish	forward	CATGATTTTTGACCTAACCGTTCACTTTACCGTATATCCTAACCCTAACCGTTCAGTTACCCTATTGCCCTAACCCTAACCCTAACCCTAACCCTAACCC
ptg000433l polypolish	forward	TATTGTCACACCTATGGTTCACGTTACCGTATTGCTCCCTAACCCTAACCCTAACCCTAACCCTAACCCTAACCCTAACCCTAACCCTAACCCTAACCCT
ptg000435l polypolish	reverse	TAGGGTTAGGGTTAGGGTTAGGGTTAGGGTTAGGGTTAGGGTTAGGGTTAGGGTTAGGGTTAGGGTTAGGTAACACGTAACCGAACCAGTAGTATGACAT
ptg000437l polypolish	reverse	GGTTAGGGTTAGGGTTAGGGTTAGGGTTAGGGTTAGGGTTAGGGTTAGGGTTAGGGCTTAGGGTAGCAATACAGCGATAACTGAACGAAGTAGGCTAGCA
ptg000439l polypolish	forward	CGATGTCCTAATGACCCTAACCCTGAACCCTAACCCTAACCCTAACCCTAACCCTAACCCTAACCCTAACCCTAACCCTAACCCTAACCCTAACCCTAAC
ptg000444l polypolish	reverse	TTAGGGTTAGGGTTAGGGTTAGGGTTAGGGTTAGGGTTAGGGTTAGGGTTAGGGTTGAGGGTTAGGGTTAGGGTAGCGTTACTAGTTAGGGCGATAGGTT
ptg000447l polypolish	reverse	GGGTTAGGGTTAGGGTTAGGGTTAGGGTTAGGGTTAGGGTTAGGGTTAGGGTTAGGGTTAGGGTTAGCAATAGGGTAACCTGAACCTAAGTAGGGTTACA
ptg000451l polypolish	forward	CAATATAGCTTGGCTCTGCTTTCTTCTTCTTTGAGCTGCAGGCCTCACTTCGTTCGCTACGCCTTCTCCAACCCTAACCCTAATCACTAACCCTAACCCT
ptg000451l polypolish	reverse	GTTAGGGTTAGGGTTAGGGTTAGGGTTAGGGTTAGGGTTAGGGTTAGGGTTAGGGTTAGGGTTAGGGTTAGGGAGACGTAACTGACTGGTAGGGTTACAT
ptg000453l polypolish	reverse	AGGGTTAGGGTTAGGGTTAGGGTTAGGGTTAGGGTTAGGGTTAGGGTTAGGGTTAGGGTTAGGGTTATGGAATAGGTTAGGGTTAGGGTTAGCATAAACA
ptg000454l polypolish	reverse	TGATCAGCCTATCAGGGTATCTTTTAGGGTTAGGGTTAGGGTCAACCGAGAGTTATCCATGCCATGCCATGCCATGCATACCATACCGAAGTATTGCACA
ptg000466l polypolish	reverse	TAGGGTTAGGGTTAGGGTTAGGGTTAGGGTTAGGGTTAGGGTTAGGGTTAGGGTTAGGGTTAGGAGCAATACCTAACTGAACCAAGTACAGTACATAACA
ptg000469l polypolish	forward	TTACCTTCTGTACCCTCAGTTCAGTTACGTATTGCTCCCTAACCCTAACCCTAACCCTAACCCTAACCCTAACCCTAACCCTAACCCTAACCCTAACCCT
ptg000481l polypolish	forward	TGGTACCCTAACCTACGTTTGCTCCTAAGGCCTAAGCCCTATAACTCATGTAACTGTATACCTTGGTTACCACTAACCCTAACCCTAACCCTAACCCTAA
ptg000481l polypolish	reverse	GTTAGGGTTAGGGTTAGGGTTAGGGTTAGGGTTAGGGTTAGGGTTAGGGTTAGGGTTAGGGTTAGGGTTAGGGTTAGGGTTAGGGTTAGGGTTAGGGTTA
ptg000482l polypolish	forward	AGATTTTGTAACCCTCTCTTAACCCTTGATCCCTAGTCTTCACTATTCCTAACCCTAACCCTAACCCTAACCCTAACCCTAACCCTAACCCTAACCCTAA
ptg000484l polypolish	reverse	GGGTTAGGGTTAGGGTTAGGGTTAGGGTTAGGGTTAGGGTTAGGGTTAGGGTTAGGGTTAGGGTTAGGGTTAGGAGGCATATGTAATCTTAGGGTTACAT
ptg000486l polypolish	reverse	GGGTTAGGGTTAGGGTTAGGGTTAGGGTTAGGGTTAGGGTTAGGGTTAGGGTTAGGGTTAGGGTAGCAATAGATGTAATCAACGAGCGTTAGGATAAACA
ptg000500l polypolish	forward	ATACTGCATACCCTAACCCGTTGAATGTCATGCTAACCCTAAACTCTAACCCTAACCGCTAACCCTAATCGCCTAACGGTGAGTCTAACTGCTAACCTAA
ptg000500l polypolish	reverse	TTAGGGTTAGGGTTAGGGTTAGGGTTAGGGTTAGGGTTAGGGTTAGGGTTAGGGTTAGGGTTAGGGTTAGGGTTAGGGTTAGGGTTTAGGGTTAATGTTA
ptg000503l polypolish	reverse	TAGGGTTAGGGTTAGGGTTAGGGTTAGGGTTAGGGTTAGGGTTAGGGTTAGGTTAGCAAGGCACAGACATCTAAGTCAAGTACATATGAGGTAGAGCATA
ptg000504l polypolish	forward	ATGTTGATGTTGCACTACTACTGGTTCAGTTACGTATTGCTCCTAACCCTAACCCTAACCCTAACCCTAACCCTAACCCTAACCCTAACCCTAACCCTAA
ptg000511l polypolish	forward	AAACCTATTGCAACCCTAGCCCTAACCCTAACCCTAACCCTAACCCTAACCCTTTCCCTAACTAACCCTAACCCTATCCCTAACCCTAACCCTAACCCTA
ptg000511l polypolish	reverse	GTTAAGGTTAGGGATAGGGTTAGAAGTTAGGGTTAGGGTTAGGCATTATTAGGGTTAGGGGAACAAGGAGTAACTGAAAAGTTGAAGGCTGGGAATAAAA
ptg000516l polypolish	forward	ACCCTAACAGTAAGCTAACCTATGTACTGTCTCTAACCCTAACCCTAACCCTAACCCTAACCCTAACCCTAACCCTAACCCTAACCCTAACCCTAACCCT
ptg000531l polypolish	forward	TTATTAGCATCTATGTTGGTTAGCTACTAGGTATACCCTAACCCTAACCCTAACCCTAACCCTAACCCTAACCCTAACCCTAACCCTAACCCTAACCCTA
ptg000536l polypolish	reverse	GTTAGGGTTAGGGTTAGGGTTAGGGTTAGGGTTAGGGTTAGGGTTAGGGTTAGGGTTAGGGTTAGGAGCAAGACCTAAGCTGAACGAAGTGGTAGGACTA
ptg000538l polypolish	forward	TAAACAGTTCTAATGACTTGTGCATTAACTAACCAGTTGAATATACCTCCAGTTTACTAACCCTAGCACCATGTCCTAACCATATACTACAGATTGTTTC
ptg000548l polypolish	forward	TAGTTTATGTCTAACCATGTCTAACCTACTGGTTCATCTCCTGACTCCTAACCCTAACCCTAACCCTAACCCTAACCCTAACCCTAACCCTAACCCTAAC
ptg000555l polypolish	forward	TTATTAGGATGGGAAATGGAATGGGTATGGGATGTTAGGTAATCTACTGGTTCAGTACTATGGGCTTAATCTGCCTATGCTAACCCTAACCCTAACCCTA
ptg000555l polypolish	reverse	GTTAGGGTTAGGGTTAGGGTTAGGGTTAGGGTTAGGGTTAGGGTTAGGGTTAGGGTTAGGGTTAGGGTTAGGGTTAGAGATAGGGTATGAACAGGGTAGG
ptg000561l polypolish	forward	TATTTTAACCCTAAACTTCGGCTATGTTGTATGTGCCCTAACCCTAACCCTAACCCTAACCCTAACCCTAACCCTAACCCTAACCCTAACCCTAACCCTA
ptg000568l polypolish	reverse	GGTTAGGGTTAGGGTTAGGGTTAGGGTTAGGGTTAGGGTTAGGGTTAGGGTTAGGGTTAGGGTTAGCAATACCTAGGTGAACCAAGGCATAGGATAACAT
ptg000569l polypolish	reverse	AGGGTTAGGGTTAGGGTTAGGGTTAGGGTTAGGGTTAGGAGTTAGGGTTAGGGTTAGGGTTAGGAGACTAACATAACCCTAAGTCTAGGGTTACCCTAAC
ptg000574l polypolish	reverse	TAGGGTTAGGGTTAGGGTTAGGGTTAGGGTTAGGGTTAGGGTTAGGGTTAGGGTTAGGGTTAGGGTTAGGGTTAGGGTTAGGGTTAGGGTTAGACTACAT
ptg000584l polypolish	reverse	TAGGGTTAGGGTTAGGGTTAGGGTTAGGGTTAGGGTTAGACGTTAAGTTAGGGTTACCGTTAGGGTTAGGAGCAATCCTACTGAACTATGTACACTAACT
ptg000585l polypolish	reverse	AGGGTTAGGGTTAGGGTTAGTAAGTTAGGGTTAGGGTGTAGACTAGGTATCACTAGAACTGAACCATTCACACACAACCCTAACCAAGTACAGGCACTAA
ptg000587l polypolish	forward	ATCACCTATTGCTAACCCTAACCCTAACCCTAACCCTAACCCTAACCCTAACCCTAACCCTAACCCTAACCACTAACCCTAACCCTAACCCTAACCCTAA
ptg000587l polypolish	reverse	GTTAGGGTTAGGTTAGGGTTAGGGCTTACATCCTCAGGCATATCATTACGGTCCCTCATATTGTTAGGGCTTCATTATCCTTAGTTGATATTAGGTTATT
ptg000588l polypolish	forward	TATCTAACCTAACTCTAACTTACACTCCTGTACCTCTAACCTCTAACCCTAACCCTAATCTACCCTAACCTAACCCTAACCCTAACCCTAATCCCTAAAT
ptg000588l polypolish	reverse	GGTTAGGGTTAGGGTTAGGGTTAGGGTTAGGGTTAGGGTTAGGGTTAGGGTTAGGGTTAGGGTTAGGGTTAGGGTTAGGGTTAGGGAGCAATACGTGAAA
ptg000595l polypolish	forward	TATGCCTGGTACTTGGTACAGATTCTATACCCTAACCCTAACCCTAACCCTAACCCTAACCCTAACCCTAACCCTAACCCTAACCCTAACCCTAACCCTA
ptg000597l polypolish	reverse	AGGGTTAGGGTTAGGGTTAGGGTTAGGGTTAGGGTTAGGGTTAGGGTTAGGGTTAGGGTTAGGGTTAGGGTTAGGGTTAGGGTTAGGGTTAGGGATTGGT
ptg000598l polypolish	forward	ACTATGTATGAGCTCCCTAACTCTAACCCTAAGGATAACCCCTAATTCTAACCCTAACCGTAACCCTAAGTGCTAACCGGGAATGTAAACTCGATTTAGG
ptg000599l polypolish	reverse	GGGTTAGGGTTAGGGTTAGGGTTAGGGTTAGGGTTAGGGTTAGGGTTAGGGTTAGGGTTAGGGTTAGGAGTTAGGGTTACTTGAACGATAGATGTAACAT
ptg000603l polypolish	reverse	GTTAGGGTTAGGGTTAGGGTTAGGGTTAGGGTTAGGGTTAGGGTTAGGGTTAGGGTTAGGGTTAGGGTTAGGGTAGAATACTAACTGATCAGTAGACCAT
ptg000606l polypolish	reverse	GTTAGGGTTAGGGTTAGGGTTAGGGTTAGGGTTAGGGTTAGGGTTAGGGTTAGGCTTAGGGTTAGGTTAGGGAGCAATCGATCTACCAGTGGAGTCCGAT
ptg000615l polypolish	forward	TTATGTAACCTAGTCAGATCTTAGAGGAAGCCCTACTGCATAACCCTAACCCTAACCCTAACCCTAACCCTAACCCTAACCCTAACCCTAACCCTAACCC
ptg000618l polypolish	forward	GTATTGTACTGCTATGGTTTACCTACTGGTTCGCTTGAATACTACCCTAATGCTCCTAACCCTAACCCTAACCCTAACCCTAACCCTAACCCTAACCCTA
ptg000618l polypolish	reverse	TTAGGGTTAGGGTTAGGGTTAGGGTTAGGAGTTACTGTAAGGAACGTATAGGGTCTAGGGTTAGACATTAGGGTCAAGGACATAGGGTGTAGCAATACGT
ptg000619l polypolish	reverse	AGGGTTAGGGTTAGGGTTAGGGTTAGGGTTAGGGTTAGGGTTAGGGTTAGGGTTAGGGTTAGGGTTAGGAGCAATAGACTTAACTTAACCAAGTTGATTT
ptg000623l polypolish	reverse	AGGGTTAGGGTTAGGGTTAGGGTTAGGGTTAGGGTTAGGGTTAGGGTTAGGGTTAGGGTTAGGGTTAGGGTTAGGGTAGGGTTAGTTAGGACCAATACTG
ptg000627l polypolish	forward	GCTATGTGAACTGCCTAACCTGTTACTTACTTGAACCCTTACCGTATTGCTCCTAACCCTAACCCTAACCCTAACCCTAACCCTAACCCTAACCCTAACC
ptg000630l polypolish	forward	ATGTAACCTACTCGTTCGTTACGTATACCTCCTAACTCCTAACCCAATGTAACCCTAACCCTAACCCTAACCCTAACCCTAACCCTAACCCTAACCCTAA
ptg000631l polypolish	reverse	TTAGGGTTAGGGTTAGGGTTAGGGTTAGGGTTAGGGGCAATTATTGGGTTAGGGTTAGGGTTAGGGAGAGATGTAACTGATACCAGACAGGCATAAACAT
ptg000632l polypolish	forward	TAACCCTAACCCTAACCCTATACCCTAACCCTAACCCTAACCCTAACCCTAACCCTAACCCTAACCCTAACCCTAACCCTAACCCTAACCCTAACCCTAA
ptg000633l polypolish	forward	AGTCTTACTCGGTTCAGTTAAGTTATGGGTGTACCCTAACCCTAACCCTAACCCTAACCCTAACCCTAACCCTAACCCTAACCCTAACCCTAACCCTAAC
ptg000651l polypolish	forward	TGTAAATTCGTTCCCATTACGTATGACGCTAACCCGTAACCCTAACCCTAACCCTAACCCTAACCCTAACCCTAACCCTAACCCTAACCCTAACCCTAAC
ptg000658l polypolish	forward	ACGTCTGTGTGTTAACCCTACTCTAGGTTCAGTATGCTAACTCTATTAATCCATTACATATACTCTAACCCTAACCCTAACCCTAACCCTAACCCTAACC
ptg000660l polypolish	forward	TATGTTACTATATGTACTGTCAGTTACGTCATTAGTCCCTAACCCTAACCCTAACCCTAACCCTAACCCTAACCCTAACCCTAACCCTAACCCTAACCCT
ptg000661l polypolish	reverse	TTAGGGTTATTGTGAAGGAGTTAGGGTTAGGGTTAGGGTTAGGGTTAGGGTTAGGGTTAGGCCCAGAGTTGAGCAGGCTGACCGAGTTCCATCGATGCTA
ptg000674l polypolish	forward	TGTTATGTTACTTACTGCTAACCGTTACGTATTGCTCCTAACCCTAACCCTAACCCTAACCCTAACCCTAACCCTAACCCTAACCCTAACCCTAACCCTA
ptg000677l polypolish	reverse	GGTTAGGGTTAGGGTTAGGGTTAGGGTTAGGGTTAGGGTTAGGGTTAGGGTTAGGGTTAGGGTTAGGAGCAATACGATGTAACTGAACCAGTAAGGATCA
ptg000678l polypolish	forward	GTTATGTACGTAATTTTACTTCGTTCAGGGACGTATTGCTGTGGCTAATAGGGTATCAAAATCCTAATGACGATTGCTCCCTAACCCTAACCCTAACCCT
ptg000695l polypolish	forward	TACCAGGAATTGCCCTAACCCTAACCCTAACCCTAACCCTATTTGCTTGACTAACCCTAACCCTAACCCTAACCCTAACCCTAACCCTAACCCTAACCCT
ptg000706l polypolish	forward	ATCTGGCGAGAACATGACTTATCCCTATTGCCCTAACCCTAACCCTAACCCTAACCCTAACCCTAACCCTAACCCTAACCCTAACCCTAACCCTAACCCT
ptg000711l polypolish	reverse	GGTTAGGGTTAGGGTTAGGGTTAGGGTTAGATAGGTTAGGGTTAGGTTAGGTCTAGGGTTAGGGTTAGGTTGTCTGTAGGAAATCTAACTGAACAAGATA
ptg000721l polypolish	reverse	GGTTAGGGTTAGGGTTAGGGTTAGGGTTAGGGTTAGGGTTAGGGTTAGCGTTAGGATTACCGTAAACATGAACGAGAAGGGACATTAGGACAATCGTAAA
ptg000726l polypolish	forward	CTAACTGTACTTCGTTCACGTTACGTATCTGTTCTTAACTACTAACCCTATTCACCCTAACCCTAACCGTAACCCTAACCCTAACCCTAACCCTAACCCT
ptg000726l polypolish	reverse	TTAGGGTTAGGGTTAGGGTTAGGGTTAGGGTTAGGGTTAGGGTTAGGGTTAGGGTTAGGGTTAGGGTTAGGCAATACGTAATGTCTAGTAGTATCGACAT
ptg000728l polypolish	forward	CCCTAACCCTAACCCTAACCCTAACCCTAACCCTAACCCTAACCCTAACCCTAACCCTAACCCTAACCCTAACCCTAACCCTAACCCTAACCCTAACCCT
ptg000735l polypolish	forward	TCTCTGTCCTACCTACTGTCATGTTAACCCTGCTTGGCCCTTACCCAGTATACTTCGTTCTAACCCTAACCCTAACCCTAACCCTAACCCTAACCCTAAC
ptg000736l polypolish	reverse	GTTAGGGTTAGGGTTAGGGTTAGGGTTAGGGTTAGGGTTAGGGTTAGGGTTAGGGTTAGCAAGTAGGATTACCCTTGTAGGGTTAGGGGGGGCGTACGTT
ptg000746l polypolish	reverse	TAGGGTTAGGGTTAGGGTTAGGGTAGGGTTAGGGTTAGGGTTAGGGTTAGGGTTAGGGTTAGGGTTAGGCATGTTAAAAGGGTTCGCCTCTAGGGTTAGG
ptg000747l polypolish	forward	TTAATACTCTATTTTACCTTACTCGTTCAGTTACGTATTGCTCCCTAACCCTAACCCTAACCCTAACCCTAACCCTAACCCTAACCCTAACCCTAACCCT
ptg000749l polypolish	forward	TTCTAACCTATTGGTTCACTATATTGCCCTAACCCTAACCCTAACCCTAACCCTAACCCTAACCCTAACCCTAACCCTAACCCTAACCCTAACCCTAACC
ptg000751l polypolish	forward	GTTATCTCCCCCTGGTACCTCGTCAGTTACCGTATTGCTCCTAACCCTAACCCTAACCCTAACCCTAACCCTAACCCTAACCCTAACCCTAACCCTAACC
ptg000763l polypolish	forward	ATGTATATTGTATTGGCATCTTCAATTGACGTCTTAAACCTAATCCCTAACTTTAACGGCTAAGGTTAACCCTAACCCTAACCCTAAATTTAGCCCTAAC
ptg000777l polypolish	reverse	GGTTAGGGTTAGGGTTAGGGTTAGGGTTAGGGTTAGGGTTAGGGTTAGGGTTAGGGTTAGGGTTAGGTTAGGACCAAGTACGTAACGAACGAGTAAACAT
ptg000784l polypolish	reverse	TTAGGGTTAGGGTTAGGGTTAGGGTTAGGGTTAGGGTTAGGGTTAGGGTTACGTAAATTTAGGGCAGGGCATACGTAACTGAGACCAAGGTCAGACACAA
ptg000791l polypolish	reverse	AGGGTTAGGGTTAGGGTTAGGGTTAGGGTTAGGGTTAGGGTTAGGGTTAGGGTTAGGGTTAGGGTTAGGGAGAATACGTAACTGAAGGTTAGGCTAACAC
ptg000792l polypolish	forward	TGCTTATGTCTAAGCCTGCCTTGAACCTTCAGTAGTTACCCTATTGCTCCCTAACCCTAACCCTAACCCTAACCCTAACCCTAACCCTAACCCTAACCCT
ptg000800l polypolish	forward	TGTATACCTACTGGACTCGTCTATTGTTACGTAACCCTAACCCTAACCCTAACCCTAACCCTAACCCTAACCCTAACCCTAACCCTAACCCTAACCCTAA
ptg000800l polypolish	reverse	AGGGTTAGGGTTAGGGTTAGGGTTAGGGTTAGGGTTAGGGTTAGGGTTAGGGTTAGGGTTAGGAGCAATACGAACTGAACCCAAGTACAGGTAACATAAG
ptg000806l polypolish	forward	TCGATATTGCTACCCGTCGAAGATCAAGTGTAACCTACTAGGTTCATGGTTTGAGCCGTATTCGACACTACCCTAAGCCTAAGCCCTAACCCTAACCCTA
ptg000806l polypolish	reverse	TTAGGGTTAGGGTTAGGGTTAGGGTTAGGGTTAGGGTTAGGGTTAGGGTTAGGGTTAGGGACAATACGTAACTGAACGAAGTTTTCATGGTAAGAACTAG
ptg000808l polypolish	forward	TGTAATGTTACATTGACTGGCTCATTACCCTGCTTTACCTATACCTAACCCTAACCCTAACCCTAACCCTAACCCTAAACCTAACCCTAACCCTAACCCT
ptg000809l polypolish	forward	ATAACCCTATTACCCTAACCCTAACCCTAACCCTAACCCTAACCCTAACCCTAACCCTAACCCTAACCCTAACCCTAACCCTAACCCTAACCCTAACCCT
ptg000811l polypolish	forward	TGTTATCCTCACTCACATTCTTAGGTTACGTATTATGGCTAACCCTAACCCTAACCCTAACCCTAACCCTAACCCTAACCCTAACCCTAACCCTAACCCT
ptg000811l polypolish	reverse	TTAGGGTTAGGGTTAGGGTTAGGGTTAGGGTTAGGGTTAGGGTTAGGGTTAGGGTTAGGGTTAGGGAGTAATACGGTAAGGGAACCAAGTAGGTTACACA
ptg000838l polypolish	forward	CCACCACCGATTGATCCCTAACCCTACCCTAACCCTATTCCGTAACCTAACCCTAACCCTAACCCTAACCCTAACCCTAACCCTAACCCTAACCCTAACC
ptg000841l polypolish	forward	GTAGTTATACTTTACCTGGTTCAGTTACGTATTGCTGCCTTGGTCCCAGTTTATGCCCTAACCCTAACCCTAACCCTATACCCTAACCCTAACCCTAACC
ptg000880l polypolish	reverse	TTAGGGTTAGGGTTAGGGTTAGGGTTAGGGTTAGGGTTAGGGTTAGGGTTAGGGTTAGGCTTAGGGTTAAGCTAGGTAACTAACCAGTAGATTTACATAA
ptg000881l polypolish	forward	GTTATTCCTGTTCTTTCGTTCAGTTAGATATTGCTCCTAACCCTAATTGCCCTAACCCTAACCCTAACCCTAACCCTAACCCTAACCCTAACCCTAACCC
ptg000893l polypolish	reverse	AACTGAACGAGGTTAACCCTAGGCACCAGGCACTTAGGTTAGGGTTAGGGTTCAGAATTAGGGTCCATACCAAATAACCCTAGGGCTAGGGAGCAATCTA
ptg000895l polypolish	reverse	TTAGGGTTAGGGTTAGGGTTAGGGTTAGGGTTAGGGTTAGGGTTAGGGTTAGGGTTAGGGTTAGGGTTAGGGAGCAATACGTAATTAGCTAGTGTACAAA
ptg000909l polypolish	forward	TATATCTGATAACTACTTTAATGTTCCCTAACCCTAACCCTAACCCTAACCCTAACCCTAACCCTAACCCTAACCCTAACCCTAACCCTAACCCTAACCC
ptg000937l polypolish	reverse	GGGTTAGGGTTAGGGTTAGGGTTAGGGTTAGGGTTAGGGTTAGGGTTAGGGTTAGGGGTTAGGGTTAGGGTTAGGGTTAGTTGTCGGGTAAGCGTGGGTG
ptg000945l polypolish	reverse	TTAGGGTTAGGGTTACGGTTAGGGTTACGAATTCCAGTTAGGGTAGGGTTAGCCGGTTAGGGTTAGGATCATTACGTAACTGAACCAGTATTTTACACAT
ptg000974l polypolish	forward	ACCCTAACCCTAACCCTAACCATACTACCCTAACCCTAACCCTAACCCTAACCCTAACCCTAACCCTAACCCTAACCCTAACCCTAACCCTAACCCTAAC
ptg001014l polypolish	forward	TTTATGTTACACATAATGATCCACTTACTATTGCTCTAACCCTATCCAGTTACGTATTGCCCTAACCCTAACCCTAACCCTAACCCTAACCCTAACCCTA
ptg001016l polypolish	reverse	GGGTTAGGGTTAGGGTTAGGGTTAGGGTTAGGGTTAGGGTTAGGGTTAGGGTTAGGGTTAGGGTTAGGCAGCAATAGGGTTACTGAACCAGTAGTAGGGA
ptg001057l polypolish	forward	TTTGGGAGACTATTTGGTCGGTCAACCTGAGGGTGCTAATCAAATTTAATAGAACATTACTCCTATATTTTCATATAACTAACGCGCGCTAGTAGTATAG
ptg001060l polypolish	reverse	AGGGTTAGGGTTAAACTCCAGCGGTTAGAGTTAGGTTAGAGCTAACTGTTAGGGTTAGGTTAGTACAAATCATGTACCTAATAAAAGCAGATCTAAAAGA
ptg001081l polypolish	reverse	AGGGTTAGGGTTAGGGTTAGGGTTAGGGTTAGGGTTAGGGTTAGGGTTAGGGTATAGGAGACAATACGTAGTTAGCTATGTTAGGGTTAGCAATAAACAT
ptg001083l polypolish	forward	TATGCCCTACCCTTCGTTCAGTTACAGCTAATGCTACCCTAACCCTAACCCTAACCCTAACCCTAACCCTAACCCTAACCCTAACCCTAACCCTAACCCT
ptg001091l polypolish	forward	TATGTTACTCCGTCTGCATTTTCATTGTATGGAACCCTCAACCATCCATTACATCTCTGGACTAATCCTAATAGTAACATTAACCCTAACCCTGTACCCT
ptg001094l polypolish	forward	ATGTCTATACTACTGTATCAGTTACGTATTGCTAACCTAACCCTAACCCTAACCCTAACCCTAACCCTAACCCTAACCCTAACCCTAACCCTAACCCTAA
ptg001113l polypolish	forward	ATGTTACAAATCTGCTTCGGCTCAGTTACTATTGCTCGCTAACCCTATTGCTACCCTAACCCTAACCCTAACCCTAACCCTAACCCTAACCCTAACCCTA
ptg001113l polypolish	reverse	AGGGTTAGGGTTAGGGTTACGGTTAGGGTTAGGAGTTAGGGTTAGGGTTAGGGGTTATTGGTTAGTGGTTAGACAAATACGTAGGTCTGAATTTACGCAT
ptg001141l polypolish	forward	CCTAACCCTAACCCTAACCCTAACCCTAACCCTAACCCTAACCCTAACCCTAACCCTAACCCTAACCCTAACCCTAACCCTAACCCTAACCCTAACCCTA
ptg001141l polypolish	reverse	GTTAGGGTTAGGGTTAGGGTTAGGGTTAGGGTTAGGGTTAGGGTTAGGGTTAGGGTTAGGGTAACAATCAGTATAGTGCAGATTTATGGTTACACATAAC
ptg001209l polypolish	reverse	TTAGGGTTAGGGTTAGGGTTAGGGTTAGGGTTAGGGTTAGGGTTAGGGTTAGGGTTAGGGTTAGGAGCAATACGTAACTGAACGAGTAGAGTATATAGTA
ptg001230l polypolish	reverse	AGCAGTAAAATAAGCTATAGCTAAAAAGATTGAACTTGCTATAATTATTTGTAAACCTATGTTAGTTATTACCGATATCTCTGAAGATAATCCAAAGATA
ptg001240l polypolish	forward	TTGATTACGATCATGTACTACTATTGACTCCTAACCTAACCCTAACCCTAACCCTAACCCTAACCCTAACCCTAACCCTAACCCTAACCCTAACCCTAAC
ptg001365l polypolish	forward	TCTCAATTAGGTTCAGTCTATATGCTACCCTAACCCTAACCCTAACCCTAACCCTAACCCTAACCCTAACCCTAACCCTAACCCTAACCCTAACCCTAAC
ptg001411l polypolish	forward	GTACTGCTTTCTTAGGTTATACTCTAGTATGGGGTACAATGAGTTTCTGGGGTGCAACGGTAATAACTAACCTATTATCAGCAATCCCAGTAATAGGAGG
ptg001433l polypolish	forward	TGAACGCTTGGCTGCCACAAGCCAGTTATCCCTGTGGTAACTAACTTTTCTTAACTAGCCTTAAATCATTACGTATTGCTAAAGGATCGATAGGCCACAC
ptg001440l polypolish	reverse	GTTAGGGTTAGGGTTAGTAGGTTAGGGTTAGACAAGGCAATACGTAACTGAACGAAGTAAGTATCACTGAGCTATCTGGGTCTTAGCTCTGTGGTCTGTC

Telomeres found: 302 (140 forward, 162 reverse)
