ptg000008l polypolish	forward	TAACCCTAACCCTAACCCTAACCCTAACCCTAACCCTAACCCTAACCCTAACCCTAACCCTAACCCTAACCCTAACCCTAACCCTAACCCTAACCCTAAC
ptg000014l polypolish	reverse	AGGGTTAGGGTTAGGGTTAGGGAATTAGGGTTAGTGTTAGGGTTAGGGTTAGGGTTAGGGTTAGGGTTAGTGGATAGGGTTAGGGTTAGGGTTAGGGTTG
ptg000016l polypolish	forward	GTGTAACCTACTTGGTTCAGTTACGTATTGAACCCTAACCCTAACCCTAACCCTAACCCTAACCCTAACCCTAACCCTAACCCTAACCCTAACCCTAACC
ptg000018l polypolish	forward	ACCCTAGCTACTATACTCGTTAAACTAGATTCTACCTAACCCTAACCCTAACCCTAACCCTAACCCTAACCCTAACCCTAACCCTAACCCTAACCCTAAC
ptg000028l polypolish	forward	TAACCCTAACCCTAACCCTAACCCTAACCCTAACCCTAACCCTAACCCTAACCCTAACCCTAACCCTAACCCTAACCCTAACCCTAACCCTAACCCTAAC
ptg000033l polypolish	reverse	GTTAGGGTTAGGGTTAGGGTTAGGGTTAGGGTTAGGGTTAGGGTTAGGGTTAGGGTTAGGGTTAGGGTTAGGGTTAGCCCTAGATGGTTAGGGTTAGGCT
ptg000034l polypolish	reverse	TTAGGGTTAGGGTTAGGGTTAGGGTTAGGGTTAGGGTTAGGGTTAGGGTTAGGGTTAGGGTTAGCAGTATGTAACTGACACCAAGCACACGTAGTCGATC
ptg000035l polypolish	forward	TTAATTATTGCTAACCCTAACTAACCTAACCCTAACCCTAAATGTATTGCTGTACCCTACTTCTTCAGGCTACCTATTCTCATTTAACCCTAACCCTAAC
ptg000037l polypolish	forward	CATAACCCTAACCCTAACCCTAACCCTAACCCTAACCCTAACCCTAACCCTAACCCTAACCCTAACCCTAACCCTAACCCTAACCCTAACCCTAACCCTA
ptg000045l polypolish	reverse	GTTAGGGTTAGGGTTAGGGTTAGGGTTAGGGTTAGGGTTAGGGTTAGGGTTAGGGTTAGGGTTCTTGCAAGACAGTAACTGAACCAAGGAGACATAACAC
ptg000048l polypolish	reverse	TTAGGGTTAGGGTTAGGGTTAGGGTTAGGGTTAGGGTTAGGGTTAGGGTTAGGGTTAGTGGTTAGGGTTAGGGTAGCATAAGACAAGAACCAATAATTAA
ptg000049l polypolish	forward	GCCCTCTACAAACGTTCAGTTACGTATTGCTGCACTTTACTCCTAACCCTAAGCCTAACCCTAACCCTAACCCTAACCCTAACCCTAACCCTAACCCTAA
ptg000051l polypolish	reverse	GTTAGGGTTAGGGTTAGGGTTAGGGTTAGGGTTAGGGTTAGGGTTAGGGTTAGGGTTAGGGTTAGGGTTAGGGTTAGGGTTAGGGTTAGGGTTAGGGTTA
ptg000052l polypolish	reverse	AGGGTTAGGGTTAGGGTTAGGGTTAGGGTTAGGGTTAGGGTTAGGGTTAGGGTTAGGGTTAGGGTAGACTGATATGATGATTAGTAGGTTACATAAACAT
ptg000053l polypolish	forward	TGCCTCACTTAGTTAGTCCTAACCCTAACCCTAACCCTAACCCTAACCCTAACCCTAACCCTAACCCTAACCCTAACCCTAACCCTAACCCTAACCCTAA
ptg000054l polypolish	forward	TTGCTTCGGTTAGATTACATATACTTACCCCTAACCCTAACCCTAACCCTAACCCTAACCCTAACCCTAACCCTAACCCTAACCCTAACCCTAACCCTAA
ptg000062l polypolish	forward	TGTCCTCTCTGGTTCAGTTAGTACTACCCTAACCCTAACCCTAACCCTAACCCTAACCCTAACCCTAACCCTATGTTAGGCATGCCTAACCCTAACCCTA
ptg000064l polypolish	forward	ATGTGTGGCTGCTGCTTGGTTCAGTTTTATATGCTCCCCCATCTTGAACCTAGGGGGGGCACAACCCTAACCCTAACCCTAACCCTAACCCTAACCCTAA
ptg000065l polypolish	reverse	GTTAGGGTTAGGGTTAGGGTTAGGGTAAAGGGTTAGAGTTAGGGTTAGGGTTAGGCTTAGGGTTAGAGCATATCGTAACTGAACGAAGTAGAGGGAGCAA
ptg000068l polypolish	reverse	AGGGTTAGGGTTAGGGTTAGGGTTAGGGTTAGGGTTAGGGTTAGGGTTAGGGTTAGGGTTAGGGTTAGGAGCAATAGGGTAATGTTACGAAGTAGAGCTA
ptg000070l polypolish	reverse	GGGTTAGGGTTAGGGTTAGGGTTAGGGTTAGGGTTAGGGTTAGGGTTAGGGTTAGGGTTAGGAGAAGACCTAGTAGCAGGCTATAGTTAGACATAATCAT
ptg000077l polypolish	reverse	GTTAGGGTTAGGGTTAGGGTTAGGGTTAGGGTTAGGGTTAGGGTTAGGGTTAGGGTTAGGGTTAGGGTTAGGGTTAGGGTTAGGGTTAGGGTTAGGGATA
ptg000086l polypolish	forward	TATGTACCCTATTCGTTCAGTTACCCTATTGCTCCCTAACCCTAACCCTAACCCTAACCCTAACCCTAACCCTAACCCTAACCCTAACCCTAACCCTAAC
ptg000088l polypolish	forward	ATGTATACTACTCGTTTCAGTTACGTAGTCTATTGCTAACCCTAACCCTAACCCTAACCCTAACCCTAACCCTAACCCTAACCCTAACCCTAACCCTAAC
ptg000089l polypolish	forward	TTACGTATTGCCCTAACCCTAACCCTAACCCTAACCCTAACCCTAAACCCTAACCCTAACCCTAACCCTAACCCTAACCCTAACCCTAGTTACCCTAACT
ptg000106l polypolish	forward	ATCTGATTTGATTACTAATCCATACTAGATCCTGTTGATAGACTGATCTAACAGATAAGCTGTGGTAAACAATAATGCTAACTAAAATAACTAACTAATC
ptg000123l polypolish	reverse	GGTTAGGGTTAGGGTTAGGGTTAGGGTTAGGGTTAGGGTTAGGGTTAGGGTTAGGGTTAGGGTTAGCAATAGGGTTAAGAACATAGGGTTACACATAAAC
ptg000125l polypolish	reverse	GGCTTAGGCTTAGGCTTAGGCTTAGGCAGGCTTAGGCTTAGGGCTAGGCTTAGGCTTAGGCTTGGGTTAGGGTTAGGGGTTAGGGTTAGGGCATTAGTCT
ptg000126l polypolish	reverse	TAGGGTTAGGGTTAGGGTTAGGGTTAGGGTTAGGGTTAGTGGTTAGGGTTAGGGTTAGGGTTAGGGTAGTATAGACTTAACTGAACCAAGTAGTATTACA
ptg000133l polypolish	forward	TATGTGTAACCTACTTGGTTCAGTTACGTCTCCTAACCCTAACCCTAACCCTAACCCTAACCCTAACCCTAACCCTAACCCTAACCCTAACTCCTAACCC
ptg000134l polypolish	forward	TTAGTCGCTTGGTTCAGTTGGCTTGCTAACCCTAACCCTAACCCTAACCCTAACCCTAACCCTAACCCTAACCCTAACCCTAACCCTAACCCTAACGTAA
ptg000146l polypolish	forward	TATACCCTAACCCTAACCCTAACCCTAACCCTAACCCTAACCCTAACCCTAACCCTAACCCTAACCCTAACCCTAACCCTAACCCTAACCCTAACCCTAA
ptg000148l polypolish	reverse	TAGGGTTAGGGTTAGGGTTAGGGTTAGGGTTAGGGTTAGGGTTAGGGTTAGGGTTAGGGTTAGGGTTAGGGTTAGGGTTAGGGTTAGGGTTAGGGTTTAG
ptg000154l polypolish	forward	AGCCTAAGCCTAACCTACTAACCCTAACCCTAACCCTAACCCTAACCCTAACCCTAACCCTAACCCTAACCCTAACCCTAACCCTAACCCTAACCCTAAC
ptg000157l polypolish	reverse	AGGGTTAGGGTTAGGGTTAGGGTTAGGGTTAGGGTTAGGGTTAGGGTTAGGGTTAGGGTTAGGGTTAGGGTTAGGGTTAGGGTTAGGGAGCAATACGTTT
ptg000159l polypolish	reverse	GGTTAGGGTTAGGGTTAGGGTTAGGGTTAGGGTTAGGGTTAGGGTTAGGGTTAGGGTTAGGGTTAGGGTTAGGGTTAGGGTTAGGGTTGGTTAGGGTTAG
ptg000160l polypolish	reverse	GTTAGGGTTAGGGTTAGGGTTAGGGTTAGGGTTAGGGTTAGGGTTAGGGTTAGGGTTAGGGTTAGGGTTAGGGTTAGGGTTAGGGTTAGGGCTAAAATAG
ptg000164l polypolish	forward	ATGTAACCCTAAGCATACCCATTGGCTAACCCTAACCCTAACCCTAACCCTAACCCTAACCCTAACCCTAACCCTAACCCTAACCCTAACCCTAACCCTA
ptg000166l polypolish	reverse	GTTAGGGTTAGGGTTAGGGTTAGGGTTAGGGTTAGGGTTAGGGTTAGGGTTAGGGTTAGGGTTAGGGTTAGGGTTAGGGTTAGGGTAGCAATCGTGGTGG
ptg000168l polypolish	reverse	AGGGTTAGGGTTAGGGTTAGGGTTAGGGTTAGGGTTAGGGTTAGGGTTAGGGTTAGGGTTAGGGTTAGCATGTAACTGAACCAAGTAGGTTACACATAAC
ptg000173l polypolish	reverse	GGTTAGGGTTAGGGTTAGGGTTAGGGTTAGGGTTAGGGTTAGGGTTAGGGTTAGGGTTAGGGTTAGGGTTAGGGTTAGGGTATAGGGTTAGGGTTAGGGT
ptg000176l polypolish	reverse	CCTTAACTTAGGGTTAGGGTATCATCCTTAGAAAAGTTAGGGTTAGGCGTTAGATCTAGGGTTACATAGAGTCAATACGGTAACGAACCAATTGATACAT
ptg000177l polypolish	forward	TGCTAACCACTAGACTTAGTTAGAACATTATATACTAACCCTAACCCTAACCCTAACCCTAACCCTAACCCTAACCCTAACCCTAACCCTAACCCTAACC
ptg000179l polypolish	reverse	GGTTAGGGTTAGGGTTAGGGTTAGGGTTAGGGTTAGGGTTAGGGTTAGGGTTAGGGTTAGGCTTAGGGTTAGGTAGTTACCATATGAACCAGTAGGTTCA
ptg000181l polypolish	reverse	GGGTTAGGGTTAGGGTTAGGGTTAGGGTTAGGGTTAGGGTTAGGTTAGGGTTAGGGTCACGGTTAGAAGTTCCAATAGACTAATAATAGAGGCTAACATA
ptg000183l polypolish	reverse	TAGGGTTAGGGTTAGGGTTAGGGTTAGGGTTAGGGTTAGGGTTAGGGTTAGGGTTAGGGTTAGGGTTAGGGTTAGGGTTAGGGTTAGGGTTAGGGTTAGG
ptg000184l polypolish	forward	AATTCCCTAACCCTAATCCCTGGTGGGTAACCCTAACCCTATACCCTAACCCTAACCCTAACCCTAACCCTATTGCCTAACCCTAAACCCTAACCCTAAC
ptg000200l polypolish	forward	TAACCCTAACCCTAACCCTAACCCTAACCCTAACCCTAACCCTAACCCTAACCCTAACCCTAACCCTAACCCTAACCCTAACCCTAACCCTAACCCTAAC
ptg000202l polypolish	forward	TATATCTACTGTACTCCATAGGTATATACTCTAACCCTAACCCTAACCCTAACCCTAACCCTAACCCTAACCCTAACCCTAACCCTAACCCTAACCCTAA
ptg000203l polypolish	reverse	TAGGGTTAGGGTTAGGGTTAGGGTTAGGGTTAGGGTTAGGGTTAGGGTTAGGGTTAGGGTTAGGGTTAGGGTTAGGGTCTAGGGTTAGGGTTAGGGTATA
ptg000206l polypolish	forward	GTTATGCTAACCCTAAACTTCGTTCATTACGTATTGCTCCTAACCCTAACCCTAACCCTAACCCTAACCCTAACCCTAACCCTAACCCTAACCCTAACCC
ptg000208l polypolish	forward	AACCCTAACCCTAACCCTAACCCTAACCCTAACCCTAACCCTAACCCTAACCCTAACCCTAACCCTAACCCTAACCCTAACCCTAACCCTAACCCTAACC
ptg000212l polypolish	reverse	AGGGTTAGGGTTAGGGTTAGGGTTAGGGTTAGGGTTAGGGTTAGGGTTAGGGTTAGGCTTAGGTAAGCAAGTACCTAGGTTATAAGTAGGTTAACATAAC
ptg000213l polypolish	forward	GTTTATGTTGTATACCTTAAGACCTAGGATTAACTCCTAATGCTAACCCTAACCCTAACCCTAACCCTAACCCTAACCCTAACCCTAACCCTAACCCTAA
ptg000216l polypolish	reverse	TAGGGTTAGGGTTAGGGTTAGGGTTAGGGTTAGGGTTAGGGTTAGGGTTAGGGTTAGGGTTAGGGTTAGAGCAATATGTAATGGTTGAGGCATGCTAGCA
ptg000218l polypolish	reverse	GTAGGGTTAGGGTTAGGGTTAGGGTTAGGGTTAGGGTTAGGGTTAGGGTTAGGGTTAGGGTTAGGGTTAGGGTTAGGGTTAGGGTTAGGGTTAGGGTTAG
ptg000219l polypolish	reverse	TAGGGTTAGGGTTAGGGTTAGGGTTAGGGTTAGGGTTAGGGTTAGGGTTAGGGACTAGGGTTTAGGCTTCGCAATCGTAAAACTGACTGAGTAGAGGGCA
ptg000221l polypolish	reverse	CTGGGTTAGGGTTCGGGTTAGGGTAGGACTAGGGGTTAGGGTTAGAAAAAGCCCCTTAGCCCCTGGGTTAGTTAGGATAAGGACACCCTAATAGGGTTAG
ptg000223l polypolish	forward	GAGTCTACTCGTTCTGTTAACCTATTCGCTCAGTTACCGTATTGCTCCTAACCCTAACCCTAACCCTAACCCTAACCCTAACCCTAACCCTAACCCTAAC
ptg000224l polypolish	reverse	GGTTAGGGTTAGGGTTAGGGTTAGGGTTAGGGTTAGGGTTAGGGTTAGGGTTAGGGTTAGGGTTAGGGAGCAATACGTAACTGAACGAGTAGGTTACATA
ptg000225l polypolish	reverse	TAGGGTTAGGGTTAGGGTTAGGGTTAGGGTTACGTAACTGAACGAAGGCAAGGCTTAGGCTTAGGCATAAGGTGTAATGAGTTAGGCTTAGGGATAAACA
ptg000227l polypolish	forward	CAAACCCTAACCCTAACCCTAACCCTAACCCTAACCCTAACTCTAACCCTAACCCTAACCCTAACCCTAACCCTAACCCTAACCCTAACCCTAACCCTAA
ptg000237l polypolish	forward	TAACTTGCACGTAACCCTGAACTACCTAACCCTAACCCTAACCCTAACCCTAACCCTAACCCTAACCCTAACCCTAACCCTAACCCTAACCCTAACCCTA
ptg000237l polypolish	reverse	AGGGAGCCATTGATTCTAGTAGACAGTACCTAAATGCAGGTTAGTTAGAAAAGGCCAGACAGGATTGGCACTCACTTCAGCAGCTCCCCTGCCTAGACAT
ptg000241l polypolish	forward	TTTATGTCTAACTTACTTCGTTCAGTTAGGTATTGCTTACCCCTAACCCTAACCCTAACCCTAACCCTAACCCTAACCCTAACCCTAACCCTAACCCTAA
ptg000245l polypolish	forward	CTAACCCTAACCCTAACCCCCCTAACCCTGACCCTAACCCTAACCCTAACCATGTTATCCTACACTGGGTTCGTCACCCTATGCTCCTAACCCTAACCCT
ptg000247l polypolish	reverse	TTAGGGTTAGGGTTAGGGTTAGGGTTAGGGTTAGGGTTAGGGTTAGGGTTAGGGTTAGGGTTAGGGTTAGGGTTAGGGTTAGGGTTAGGGTTAGGGTTAG
ptg000254l polypolish	reverse	AGGGTTAGGGTTAGGGTTAGGGTTAGGGTTAGGGTTAGGGTTAGGGTAACAATAGGGTTAGGGTTAGGGAGCAATACTAGTCTAATGAATAGGTTGCATA
ptg000256l polypolish	forward	TTCAATCTACTTCGTTCAGTTAGTATAGTCCCTAAAACTCTAACCTGCACCCTAACCCTAACCCTAACCCTAACCCTAACCCTAACCCTAACCCTAACCC
ptg000257l polypolish	reverse	GTTAGGGTTAGGGTTAGGGTTAGGGTTAGGGTTAGGGTTAGGGTTAGGGTTAGGGTTAGGGTTAGGGTTAGGGTTAGGGTTAGGGTTAGGGCAATAGGGT
ptg000263l polypolish	reverse	GGGTTAGGGTTAGGGTTAGGGTTAGGGTTAGGGTTAGGGTTAGGGTTAGGGTTAGGGTTAGGGTTAGGGTTAGGGTTAGGGTTAGGGTTAGGGTTAGGGT
ptg000264l polypolish	forward	TCACATTTGCCAATAATTGCTAACCCTAACCTAACCCTAACGCCAGTTGTCTACTATGCTTAAGCTTAACCCTAACCCTAACCCTAACCCTAACCCTAAC
ptg000266l polypolish	reverse	TAGGGTTAGGGTTAGGGTTAGGGTTAGGGTTAGGGTTAGGGTTAGGGTTAGGGTTAGGGTTAGCATTAGCGTTAAGGCTGCCAGCCATTGTAGGGCATAC
ptg000269l polypolish	reverse	GTTAGGGTTAGGGTTAGGGTTAGGGTTAGGGTTAGGGTTAGGGTTAGGGTTAGGGTTAGGGTATAGGGTTAGGGTTAGGGTTAGGGTTAGCAATACGTGG
ptg000273l polypolish	reverse	GTTAGGGTTAGGGTTAGGGTTAGGGTTAGGGTTAGGGTTAGGGTTAGGGTTAGGGTTAGGGTTAGGGTTAGGGTAACTGAACCAAGTAAGATGCCTACAC
ptg000277l polypolish	forward	TAACCCTAACCCTAACCCTAACCCTAACCCTAACCCTAACCCTAACCCTAACCCTAACCCTAACCCTAACCCTAACCCTAACCCTAACCCTAACCCTAAC
ptg000278l polypolish	forward	GCCTACCTCTGTTCAGTAACGTATATGCATCCCCCTGGTACCCTAACCCTAACCCTAACCCTAACCCTAACCCTAACCCTAACCCTAACCCTAACCCTAA
ptg000289l polypolish	reverse	TAGGGTTAGGGTTAGGGTTAGGGTTAGGGTTAGGGTTAGGGTTAGGGTTAGGGTTAGGGTTAGACCTACTTGGTAACTGAACCAAGGCATAGGGATAAAA
ptg000292l polypolish	forward	AACCCTAACCCTAACCCTAACCCTAACCCTAACCCTAACCCTAACCCTAACCCTAACCCTAACCCTAACCCTAACCCTAACCCTAACCCTAACCCTAACC
ptg000293l polypolish	forward	CCCAATTGCTAACCCTAACCCTAACCCTAACCCTAACCCTAACCCTAACCCTAACCCTAACCCTAACCCTAACCCTAACCCTAACCCTAACCCTAACCCT
ptg000295l polypolish	reverse	GTTAGGGTTAGGGTTAGGGTTAGGGTTAGGGTTAGGGTTAGGGTTAGGGTTAGGGTTAGGGTTAGGGCAATACGTAATCTAAGCCAGTAGGTTACATAAA
ptg000296l polypolish	forward	ACGTATTGCTAACCCTAACCCTAACCCTAACCCTAACCCTAACCCTAACCCTAACCCTAACCCTAACCCTAACCCTAACCCTAACCCTAACCCTAACCCT
ptg000299l polypolish	forward	TAAACCCTAACCCTAACCCTAACCCTAACCCTAACCCTAACCCTAACCCTAACCCTAACCCTAACCCTAACCCTAACCCTAACCCTAACCCTAACCCTAA
ptg000306l polypolish	forward	CCTATCTCCTAACCCTAACCCTAACCCTAACCCTAACCCTAACCCTAACCCTAACCCTAACCCTAACCCTAACCCTAACCCTAACCCTAACCCTAACCCT
ptg000307l polypolish	reverse	TAGGGTTAGGGTTAGGGTTAGGGTTAGGGTACATAGGCAATGTTAGGGTTAGGCATATTATGGTGCAAAACACACTATCTTAAGTCAAGCTGCATAAACA
ptg000312l polypolish	forward	AAGTCTAACCCTTCACCCTAATGATAACCCTATTCGCTATTCGATATACCCTAACCTTAACTGCATAAGGTACTAACCCTAACCCTAAGATAACGTAACC
ptg000314l polypolish	forward	AACCTAGCCTAACCTATGCCTAACCCTAACTAAACCCTAACATCTAACCCTAACCCTAACCCTAACCCTAACCCTAACCCTAACCCTAACCCTAACCCTA
ptg000321l polypolish	forward	TATGTATGCCTAACCCTAACCCTAAGCACCTAACCCTAACCCTAACCCTAACCCTAACCCTAACCCTAACCCTAACCCTAACCCTAACCCTAACCCTAAC
ptg000321l polypolish	reverse	TAGGGTTAGGGTTAGGGTTAGGGTTAGGGTTAGGGTTAGGGTTAGGGTTAGGGTTAGGGTTAGGGTTAGGGTTAGGGTTAGGGTAGGGGCAATTAGTGGT
ptg000330l polypolish	forward	ATGTACTGTACTTCAACTTCAATTAATTGCAATAACCCTAACCCTAACCCTAACCCTAACCCTAACCCTAACCCTAACCCTAACCCTAACCCTAACCCTA
ptg000336l polypolish	reverse	GGGTTAGGGTTAGGGTTAGGGTTAGGGTTAGGGTTAGGGTTAGGGTTAGGGTTAGGGTTAGGGTTAGGGTTAGGGTTAGGGTTAGGGTTAGGGTTAGGGT
ptg000337l polypolish	reverse	GGGTTAGGGTTAGGGTTAGGGTTAGGGTTAGGGTTAGGGTTAGGGTTAGGGTTAGGGTTAGGGTTAGGGTAGTATATGTATGGTTTAGGGTTACATAAAC
ptg000340l polypolish	reverse	TTAGGGTTAGGGTTAGGGTTAGGGTTAGGGTTAGGGTTAGGGTTAGGGTTAGGGTTAGGGTTAGGGTTAGGGTTAGGGTTAGGGTTAGGGTTAGGGTTAG
ptg000354l polypolish	reverse	GGGTTAGGGTTAGGGTTAGGGTTAGGGTTAGGGTTAGGGTTAGGGTTAGGGTTAGGGTTAGGGTTAGGGTTAGGGTAGTAGGGTTAGGTAGGGTTAGCAT
ptg000355l polypolish	reverse	AGGGTTAGGGTTAGGGTTAGGGTTAGGGTTAGGGTTAGGGTTAGGGTTAGGGTTAGGGTTAGGGGTCATAGATGTAATCAGTTAGAGTTAGGTAGTAGCA
ptg000357l polypolish	forward	TGTAACCTACTGGTTGGTTGCTCTAACCCTAACCCTAACCCTAACCCTAACCCTAACCCTAACCCTAACCCTAACCCTAACCCTAACCCTAACCCTAACC
ptg000359l polypolish	reverse	GTTAGGGTTAGGGTTAGGGTTAGGGTTAGGGTTAGGGTTAGGGTTAGGGTTAGGGTTAGGGTTAGGGTTAGGGAGCAATACGTAACTGAACCAGTAATAT
ptg000362l polypolish	forward	ACTGTAACCCTAACCCTAACCCCCTAACCCTAACCCTAACCCTAACCCTAACCCTAACCCTAACCCTAACCCTAACCCTAACCCTAACCCTAACCCTAAC
ptg000365l polypolish	forward	CCCTAACCCTAACCCTAACCCTAACCCTAACCCTAACCCTAACCCTAACCCTAACCCTAACCCTAACCCTAACCCTAACCCTAACCCTAACCCTAACCCT
ptg000368l polypolish	forward	TGTGTAACCTCGTTCAGTTACCCTATTGTCCCTAACCCTAACCCTAACCCTAACCCTAACCCTAACCCTAACCCTAACCCTAACCCTAACCCTAACCCTA
ptg000368l polypolish	reverse	TTAGGGTTAGGGTTAGGGTTAGGGTTAGGGTTAGGGTTAGGGTTAGGGTTAGGGTTAGGGTTAGGGTTAGGGTTAGGGTTAGGGTTAGGGTTAGGGTTAG
ptg000372l polypolish	reverse	TTAGGGTTAGGGTTAGGGTTAGGGTTAGGGTTAGGGTTAGGGTTAGGGTTAGGGTTAGGGTTAGGGTTAGGGTTAGGGTTAGGGTTAGGGTTAGGGTTAA
ptg000380l polypolish	reverse	TTAGGGTTAGGGTTAGGGTTAGGGTTAGGGTTAGGGTTAGGGTTAGGGTTAGGGTTAGAGCAATACCTAACTGAATACGTAAGCAGACTAACATAAACAT
ptg000385l polypolish	reverse	GTTAGGGTTAGGGTTAGGGTTAGGGTTAGGGTTAGGGTTAGGGTTAGGGTTAGGGTTAGGGTTAGGGTTAGGGTTAGGGTTAGGGTTAGGGTTAGGGTTA
ptg000388l polypolish	forward	GTTACTGTGTGTAGCCTACTGGTTAGGTAGCCTTAACTCTTGCTAACCCTAACCCTAACCCTAACCCTAACCCTAACCCTAACCCTAACCCTAACCCTAA
ptg000388l polypolish	reverse	TTAGGGTTAGGGTTAGGGTTAGGGTTAGGGTTAGGGTTAGGGTTAGGGTTAGGGTTAGGGATAGGGTTAGGCTTTAGGGTACGGTTAGGGTTATCTTTGA
ptg000389l polypolish	reverse	TAGGGTTAGGGTTAGGGTTAGGGTTAGGGTTAGGGTTAGGGTTAGGGTTAGGGTTAGGGTTAGGGTTAGGGTTACTTGAAGGTTTGGTTACGGTTAGGCA
ptg000390l polypolish	forward	ATGAAATGTGTAACCCTACTAGAACTTAGGTTAAGACCCTAACCCTAACCCTAACCCTAACCCTAACCCTAACCCTAACCCTAACCCTAACCCTAACCCT
ptg000393l polypolish	reverse	TAGGGTTAGGGTTAGGGTTAGGGTTAGGGTTAGGGTTAGGGTTAGGGTTAGGGTTAGGGTTAGGGTTAGGGTTAGGGTTAGGGTTAGGGTTAGGGTATAA
ptg000398l polypolish	reverse	GGGTTAGGGTTAGGGTTAGGGTTAGGGTTAGGGTTAGGGTTAGGGTTAGGAACCTTAGGGTTAGGGCTTAGGGCAATAGGGTAAGAAGAGTAATAGGTCT
ptg000410l polypolish	reverse	GGGTTAGGGTTAGGGTTAGGGTTAGGGTTAGGGTTAGGGTTAGGGTTAGGGTTAGGGTTAGGGTTAGGGTTAGGGTTAGGGTTAGGGTTAGGGTTAGGGT
ptg000414l polypolish	reverse	GTTAGGGTTAGGGTTAGGGTTAGGGTTAGGGTTAGGGTTAGGGTTAGGGTTAGGGTTAGGGTTAGGGTTAGGGTTAGGGTTAGGGTTAGGGTTAGGGTTA
ptg000416l polypolish	forward	TAACCCTAACCCTAACCCTAACCCTAACCCTAACCCTAACCCTAACCCTAACCCTAACCCTAACCCTAACCCTAACCCTAACCCTAACCCTAACCCTAAC
ptg000416l polypolish	reverse	TTAGGGTTAGGGTTAGGGTTAGGGTTAGGGTTAGGGTTAGGGTTAGGGTTAGGGTTAGGGTTAGGGTTAGGGTTAGGGTTAGGGTTAGGGTTAGGGTTAG
ptg000417l polypolish	forward	CTATTGCTCCCTAACCCTAACCCTAACCCTAACCCTAACCCTAACCCCTAACCCTAACCCTAACCCTAACCCTAACCCTAACCCTAACCCTAACCCTAAC
ptg000422l polypolish	reverse	TTAGGGTTAGGGTTAGGGTTAGGGTTAGGGTTAGGGTTAGGGTTAGGGTTAGGGAGCAATGACGTAACTGAACCAGTAGTTAGGCATAAACATAGTAGTA
ptg000425l polypolish	forward	TGTCTAACATACATATCACCCTAACCCTAACCCTAACCCTAACCCTAACCCTAACCCTAACCCTAACCCTAACCCTAACCCTAACCCTAACCCTAACCCT
ptg000427l polypolish	forward	CCCTAACCCTAACCCTAACCCTAACCCTAACCCTAACCCTAACCCTAACCCTAACCCTAACCCTAACCCTAACCCTAACCCTAACCCTAACCCTAACCCT
ptg000428l polypolish	forward	TGACATCTAGGCAATTGGTTCAGTTTACGTATTGCCCCTAACCCTAACCCTAACCCTAACCCTAACCCTAACCCTAACCCTAACCCTAACCCTAACCCTA
ptg000430l polypolish	reverse	GGTTAGGGTTAGGGTTAGGGTTAGGGTTAGGGTTAGGGTTAGGGTTAGGGTTAGGGTTAGGGTTAGGGTTAGGGTACATGCTTAGTCAGGCAGGCATAGC
ptg000435l polypolish	forward	GTAACGGAGTGGGTTGTCCGTAAGAAGTCTATAGAGTATTAGCCTGCTCACTCATCATGTCTAGTCTAACCGTAACCCTAACAGCTAACCCTAACCCTAA
ptg000447l polypolish	reverse	TAGGGTTAGGGTTAGGGTTAGGGTTAGGGTTAGGGTTAGGGTTAGGGTTAGGGTTAGGGTTAGGGTTAGGGTAGCAATCTAAGAACGAAGTACAGTGATA
ptg000450l polypolish	forward	TAGTCCTAACCCTAACCCTAACCCTAACCCTAACCCTAACCCTAACCCTAACCCTAACCCTAACCCTAACCCTAACCCTAACCCTAACCCTAACCCTAAC
ptg000453l polypolish	reverse	GGGTTAGGGTTAGGGTTAGGGTTAGGGTTAGGGTTAGGGTTAGGGTTAGGGTTAGGGTTAGGGTTGGGTTAGGGTTAGTTAGGGTTAGGGTTATGGCTAG
ptg000455l polypolish	reverse	AGGGTTAGGGTTAGGGTAGGGTTACCCTTAGGGTTACTAGTTAAACTTGAAAATTGGTTTTCCAAAAATTGTGGGAAATTGAATAACCAGCAATACGTAA
ptg000466l polypolish	forward	TATAACCCTAACCCTAACCCTAACCCTAACCCTAACCCTAACCCTAACCCTAACCCTAACCCTAACCCTAACCCTAACCCTAACCCTAACCCTAACCCTA
ptg000466l polypolish	reverse	TTAGGGTTAGGGTTAGGGTTAGGGTTAGGGTTAGGGTTAGGGTTAGGGTTAGGGTTAGGGTTAGGGAGCAATACGGTAATTATGTGAGGCAGACCACAAT
ptg000476l polypolish	reverse	GGGTTAGGGTTAGGGTTAGGGTTAGGGTTAGGGTTAGGGTTAGGGTTAGGGTTAGGGTTAGGGTTAGGGCAATACCTAAGGGTTAAAGTTAGATCAGACT
ptg000478l polypolish	forward	TATGCCTGCCTTGGTTCAGGTTTATGCCTAAGCCTAAGCTAAACTATCGTATTGCTCCCTAACCCTAACCCTAACCCTAACCCTAACCCTAACCCTAACC
ptg000480l polypolish	reverse	GTTAGGGTTAGGGTTAGGGTTAGGGTTAGGGTTAGGGTTAGGGTTAGGGTTAGGGTTAGGGTTAGGGTTAGGGTTAGGGTTAGGGACAATACGGGCGCTC
ptg000481l polypolish	forward	TAACTGTGATAGCTACTTTCAGTTAGTCTATAACCCTAACCCTAACCCTAACCCTAACCCTAACCCTAACCCTAACCCTAACCCTAACCCTAACCCTAAC
ptg000484l polypolish	reverse	TAGGGTTAGGGTTAGGGTTAGGGTTAGGGTTAGGGTTAGGGTTAGGGTTAGGGTTAGGGTTAGGGTTAGCAGTATGCTTAACCTAAGTAGACTAACATAA
ptg000489l polypolish	forward	CTAACCCTAACCCTAACCCTAACCCTAACCCTAACCCTAACCCTAACCCTAACCCTAACCCTAACCCTAACCCTAACCCTAACCCTAACCCTAACCCTAA
ptg000501l polypolish	reverse	GTTAGGGTTAGGGTTAGGGTTAGGGTTAGGGTTAGGGTTAGGGTTAGGGTTAGGGTTAGGGTTAGGGACAATACGTAACCTGAACCAGTTAGGGTTACAC
ptg000505l polypolish	reverse	GGGTTAGGGTTAGGGTTAGGGTTAGGGTTAGGGTTAGGGTTAGGGTTAGGGTTAGGGTTAGGGTTAGGGATAGGGTAACTGAGCAATATGAAGTAAGGGT
ptg000507l polypolish	forward	AGTTTATGCCTAACCCTAACCCTAGGAGGCATATACCCTAACCCTAACCCTAACCCTAACCCTAACCCTAACCCTAACCCTAACCCTAACCCTAACCCTA
ptg000510l polypolish	reverse	GTTAGGGTTAGGGTTAGGGTTAGGGTTAGGGTTAGGGTTAGGGTTAGGGTTAGGGTTAGGGTTAGGGGTAGCAATACCAAATAAGTCTAAGCTAACATAC
ptg000518l polypolish	forward	AAACGAATCTCTAACCCTAACCCTATCCCTAACCCTAACGATAACCTAACCAGAACCCTAACCCTAACCCTATGGCCTAACCCTACCTAGTACTCCTAAC
ptg000524l polypolish	reverse	AGGGTTAGGGTTAGGGTTAGGGTTAGGGTTAGGGTTAGGGTTAGGGTTAGGGTTAGGGTTAGGGTTAGGGTTAGCAATACGGTACGGAACCAACTGACAA
ptg000528l polypolish	forward	TCGATGTGTGGTGTAAACAGCCCTAAACTCCTTAGGTAGGCTTGCTCCTAACCCTAACCCTAACCCTAACCCTAACCCTAACCCTAACCCTAACCCTAAC
ptg000529l polypolish	reverse	GTTTAGGGTTAGGGTTAGGGTTAGGGTTAGGGTTAGGGTTAGGGTTAGGGTTAGGGTTAGGGTTAGGGTTAGGGTTAGGGTTAGGGTTAGGGTTAGGGTT
ptg000532l polypolish	reverse	TAGGGTTAGGGTTAGGGTTAGGGTTAGGGTTAGGGTTAGGGTTAGGGTTAGGGTTAGGGTTAGGGTTAGGGTTAGGGTTAGGGTTAGGGTTAGGGTTAGG
ptg000544l polypolish	reverse	GGTTAGGGTTAGGGTTAGGGTTAGGGTTAGGGTTAGGGTTAGGGTTAGGGTTAGGGTTAGGGTTAGGGTTAGCAATACGCTAACTGAACCAAGGCATACA
ptg000547l polypolish	reverse	AGGGTTAGGGTTAGGGTTAGGGTTAGGGTTAGGGTTAGGGTTAGGGTTAGGGTTAGGGTTAGGGTAGCAATACTAACTGAACCAAGTAAATAGTACATAT
ptg000549l polypolish	reverse	GGTTAGGGTTAGGGTTAGGGTTAGGGTTAGGGTTAGGGTTAGGGTTAGGGTTAGGGTTTAGGGACTAGCAAGGCTACGAAATGAACCAGTAGGCATGCAA
ptg000553l polypolish	forward	ATGTCTGTACTTCGATTCAGTTACGTATTGCTTGCCTAATCATAACCCTAACCCTAACCCTAATGCTAACCCAACCCTAACCCTAACCCTAACCCTAATG
ptg000559l polypolish	forward	ATGCTTATGTAACTAGACCCTATATGGGATCATCCTAAATGCTTAACCCTAACCCTAACCTTCAGTTACCCTAGCCTAACCCTAACCCTAACCCTAACCC
ptg000570l polypolish	reverse	GGGTTAGGGTTAGGGTTAGGGTTAGGGTTAGGGTTAGGGTTAGGGTTAGGGTTAGGGTTAGGGTTAGGGTTAGGGTTAGGGTTAGGGTTAGGGTTAGGGT
ptg000571l polypolish	reverse	TAGGGTTAGGGTTAGGGTTAGGGTTAGGGTTAGGGTTAGGGTTAGGGTTAGGGTTAGGGTTAGGGTTAGGGTTAGGGTTAGGGTTAGGGTTAGGGTTAGG
ptg000573l polypolish	forward	TAACCCTAACCCTAACCCTAACCCTAACCCTAACCCTAACCCTAACCCTAACCCTAACCCTAACCCTAACCCTAACCCTAACCCTAACCCTAACCCTAAC
ptg000580l polypolish	reverse	GGGTTAGGGTTAGGGTTAGGGTTAGGGTTAGGGTTAGGGTTAGGGTTAGGGTTAGGGTTAGGGTTAGGGTTAGGGTTAGGGTTAGGGTTAGGGTAAAAAT
ptg000583l polypolish	reverse	TAGGGTTAGGGTTAGGGTTAGGGTTAGGGTTAGGGTTAGGGTTAGGGTTAGGGTTAGGGTTAGGGTTAGGGTTAGGGTTAGGGTTAGGGTTAGGGTTAGA
ptg000586l polypolish	reverse	TAGGGTTAGGGTTAGGGTTAGGGTTAGGGTTAGGGTTAGGGTTAGGGTTAGGGTTAGGGTTAGGGTTAGGGTTAGGGTTAGGGTTAGGGTAAGTGGTTAA
ptg000587l polypolish	reverse	GGTTAGGGTTAGGGTTAGGGTTAGGGTTAGGGTTAGGGTTAGGGTTAGGGTTAGGGTTAGGGTTAGGGTTAGGGTTAGGGTTAGGGTTAGGGTTAGGGTT
ptg000588l polypolish	reverse	TTAGGGTTAGGGTTAGGGTTAGGGTTAGGGTTAGGGTTAGGGTTAGGGTTAGGGTTAGGGTTAGGGTTAGGGTTAGGGTTAGGGTTAGCAATACGTAACT
ptg000590l polypolish	reverse	AGGGTTAGGGTTAGGGTTAGGGTTAGGGTTAGGGTTAGGGTTAGGGTTAGGGTTAGGGTTAGGGTTAGGGTTAGGGACAATTAACTGAAGGTTAGGGTTA
ptg000592l polypolish	forward	CTAACCCATGTAACCCTTAACCCTATACACCTAACCCTTACCTATACTGCTAACCTAACCCTAACCCTAACCCTAACCCTAACCCTAACCCTAACCCTAA
ptg000594l polypolish	forward	ATGTTTATGTCTAACCCTAACCCATACATGTCTACCCTAACCCTAACCCTAACCCTAACCCTAACCCTAACCCTAACCCTAACCCTAACCCTAACCCTAA
ptg000601l polypolish	forward	ATATGCCTGCCTCTGGACTAGAGTACCATACAATTCCTACTAACCCTAACGCTTCAGACCCTAGCTCCCTAACCCTAACCCTAACCCTAACCCTAACCCT
ptg000605l polypolish	reverse	AGGGTTAGGGTTAGGGTTAGGGTTAGGGTTAGGGTTAGGGTTAGGGTTAGGGTTAGGGTTAGTAGCAATACCTAACTGAACCTAGAGTCAGGTTACACAT
ptg000611l polypolish	reverse	GGGTTAGGGTTAGGGTTAGGGTTAGGGTTAGGGTTAGGGTTAGGGTTAGGGTTAGGGTTAGGGTAGTATATGCAACCTAAAGTTAGGGTTAGCATAAACA
ptg000614l polypolish	reverse	AGGGTTAGGGTTAGGGTTAAGTACAGGGTTAGGGTTAGGTTAGAGTTAGATCTAGGTTCTCATTAGTCAGCTAGGATTAGGGTTGAGGGTTAGTGATATC
ptg000615l polypolish	reverse	GGGTTAGGGTTAGGGTTAGGGTTAGGGTTAGGGTTAGGGTTAGGGTTAGGGTTAGGGTTAGGGTTAGGGTTAGGGTTAGGGTTAGGGTTAGGGTTAGGGT
ptg000620l polypolish	reverse	GGTTAGGGTTAGGGTTAGGGTTAGGGTTAGGGTTAGGGTAGTTAGGGTTAGGGTTAGGGTTAGGGTAGCAATACCTAACTGAACCAGTAGGTTACATAAA
ptg000622l polypolish	reverse	AGGGTTAGGGTTAGGGTTAGGGTTAGGGTTAGGGTTAGGGTTAGGGTTAGGGTTAGGGTTAGGATTAGGGTTATGACCAGTTAGGCATTGAGTTAGGGTG
ptg000623l polypolish	forward	TAACCCTAACCCTAACCCTAACTCGTTCAGGTTAGGTATTACTCCCTAACCCTAACCCTAACCCTAACCCTAACCCTAACCCTAACCCTAACCCTAACCC
ptg000624l polypolish	reverse	GGGTTAGGGTTAGGGTTAGGGTTAGGGTTAGGGTTAGGGTTAGGGTTAGGGTTAGGGTTAGGGTTAGGGTTAGGGTTAGGGTTAGGGTTAGGGTTAGGGT
ptg000625l polypolish	reverse	GGGTTAGGGTTAGGGTTAGGGTTAGGGTTAGGGTTAGGGTTAGGGTTAGGGTTAGGGTTAGGGTTAGGGTTAGGGTTAGGGTTAGGGTTAGGCAATAATG
ptg000626l polypolish	forward	AGCTTAATTGTTACAGGACATCTATAAAACACCTAACTGAACCCGAGTTCTAAAAGAACCCTAACCCTAACCCTAACCCTAACCCTAACCCTAACCCTAA
ptg000626l polypolish	reverse	GGGTTAGGGTTAGGGTTAGGGTTAGGGTTAGGGTTAGGGTTAGGGTTAGGGTTAGGGTTAGGGTTAGGGTTAGGGTTAACACTGAAGCGAAAGGCTCATA
ptg000643l polypolish	reverse	TAGGGTTAGGGTTAGGGTTAGGGTTAGGGTTAGGGTTAGGGTTAGGGTTAGGGTTAGGGTTAGGGTTAGGGTTAGGGTTAGGGTTAGCAATTAGGTTCGG
ptg000654l polypolish	forward	TTCTGTATTGTTCACAAACGTATTGCTCCCTAACCCTAACCCTAACCCTAACCCTAACCCTAACCCTAACCCTAACCCTAACCCTAACCCTAACCCTAAC
ptg000656l polypolish	forward	TTGCCATCTAACTGATAGGCTTAACGTAATGCTACCCTAACCCTAACCCTAACCCTAACCCTAACCCTAACCCTAACCCTAACCCTAACCCTAACCCTAA
ptg000660l polypolish	reverse	GGGTTAGGGTTAGGGTTAGGGTTAGGGTTAGGGTTAGGGTTAGGGTTAGGGTTAGGGTTAGGGTTAGGGTTAGGGTTAGGGTTAGGGTTAGGGTTAGGGT
ptg000667l polypolish	forward	AGCTTAACCGCCTGGCCCTCACACATGTATCTACCCTAACCCTTAGTTAACCCTAACCCTAACCCTAACCCTAACCCTAACCCTAACCCTAACCCTAACC
ptg000673l polypolish	forward	CTTAATTCCAAGTTTAGAGATAAAACTAGCCATAACGTAACTTTAGAGCCCTAACCCTAACCCTAACCCTAACCCTAACCCTAACCCTAACCCTAACCCT
ptg000681l polypolish	forward	TAACCCTAACCCTAACCCTAACCCTAACCCTAACCCTAACCCTAACCCTAACCCTAACCCTAACCCTAACCCTAACCCTAACCCTAACCCTAACCCTAAC
ptg000682l polypolish	reverse	AGGGTTAGGGTTAGGGTTAGGGTTAGGGTTAGGGTTAGGGTTAGGGTTAGGGTTAGGGTTAGGGTTAGGGTTAGGGTAGTAGCGTTATGGAGTTCTAACA
ptg000687l polypolish	reverse	AGGGTTAGGGTTAGGGTTAGGGTTAGGGTTAGGGTTAGGGTTAGGGTTAGGGTTAGGGTTACGTGGTTAGGGTATACGTAACTGAGTCAGTAGTTACAAT
ptg000689l polypolish	reverse	AGGGTTAGGGTTAGGGTTAGGGTTAGGGTTAGGGTTAGGGTTAGGGTTAGGGTTAGGGTTAGGGTTGTAGCAATACGTAACTGAACCAAGGTACAGGCAT
ptg000690l polypolish	forward	TAACCCTAACCCTAACCCTAACCCTAACCCTAACCCTAACCCTAACCCTAACCCTAACCCTAACCCTAACCCTAACCCTAACCCTAACCCTAACCCTAAC
ptg000700l polypolish	forward	TAAGTCTAACCCTAGACAGCAAGCATTGCTCCCTAACCCTAACCCTAACCCTAACCCTAACCCTAACCCTAACCCTAACCCTAACCCTAACCCTAACCCT
ptg000701l polypolish	reverse	GTTAGGGTTAGGGTTAGGGTTAGGGTTAGGGTTAGGGTTAGGGTTAGGGTTAGGGTTAGGGTTAGGGTTAGGGTTAGGGTTAGGGTTAGGGTTAGGGTTA
ptg000702l polypolish	forward	AGTCTGTACTGGTGTCAGCTAGGTCGAGCTCCCTAACCCTAACCCTAACCCTAACCCTAACCCTAACCCTAACCCTAACCCTAACCCTAACCCTAACCCT
ptg000713l polypolish	reverse	AGGGTTAGGGTTAGGGTTAGGGTTAGGGTTAGGGTTAGGGTTAGGGTTAGGGTTAGGGTTAGCAGATACTAGGGCTACCAATAGGGTTAGCATTCACAAA
ptg000716l polypolish	forward	TATATGCTAGTCTGCTTCGGCTCAGCCTACGGTCTATGTACCCTAACCCTAACCCTAACCCTAACCCTAACCCTAACCCTAACCCTAACCCTAACCCTAA
ptg000716l polypolish	reverse	AGGGTTAGGGTTAGGGTTAGGGTTAGGGTTAGGGTTAGGGTTAGGGTTAGGGTTAGGGTTAGGGTTAGGGACAATAGGGTAAGTGAACTAGTGCAGCTAA
ptg000719l polypolish	reverse	AGGGTTAGGGTTAGGGTTAGGGTTAGGGTTAGGGTTAGGGTTAGGGTTAGGGTTAGGGTTAGGGTAAGGGTTAGGGTTAGGGTTAGACAGCAATGCGTAA
ptg000720l polypolish	reverse	AGGGTTAGGGTTAGGGTTAGGGTTAGGGTTAGGGTTAGGGTTAGGGTTAGGGTTAGGGTTAGGGTTAGGGTTAGGAATACTAACTGAACCAAGGCAGGAT
ptg000725l polypolish	reverse	GGGTTAGGGTTAGGGTTAGGGTTAGGGTTAGGGTTAGGGTTAGGGTTAGGGTTAGGGTTAGGGTTAGGGTTAGGGTTAGGGTAACTGAACCAGGGTTACA
ptg000735l polypolish	forward	TACGTATTGCTAATTGCCCTAACCCTACCCTAACCCTAACCCTAACCCTAACCCTAACCCTAACCCTAACCCTAACCCTAACCCTAACCCTAACCCTAAC
ptg000736l polypolish	reverse	AGGGTTAGGGTTAGGGTTAGGGTTAGGGTTAGGGTTAGGGTTAGGGTTAGGGTTAGGGTTAGGGTTAGGGTACACTTACATAAGTAGGCTAAATCTACAT
ptg000738l polypolish	forward	CTAACCCTAACCCTAACCCTAACCCTAACCCTAACCCTAACCCTAACCCTAACCCTAACCCTAACCCTAACCCTAACCCTAACCCTAACCCTAACCCTAA
ptg000739l polypolish	forward	GGTGATGTGCCTCGGTTTCCCTAACCCTACCCTAACCCTAACCCTAACCCTAACCCTAACCCTAACCCTAACCCTAACCCTAACCCTAACCCTAACCCTA
ptg000746l polypolish	forward	CTAATACTAGACTCCGTAACCCTAACCCTAACCCTAACCCTAACCCTAACCCTAACCCTAACCCTAACCCTAACCCTAACCGTAACCCTAACCCTAACCC
ptg000752l polypolish	forward	ACTAGACTCATTAGCACGTGCTTGCTCTAACCCTAACCCTAACCCTAACCCTAACCCTAACCCTAACCCTAACCCTAACCCTAACCCTAACCCTAACCCT
ptg000754l polypolish	forward	AGTTTATTGTCTAACCTACTTGGTTCAGTTACGTAGTAACCCTAACCCTAACCCTAACCCTAACCCTAACCCTAACCCTAACCCTAACCCTAACCCTAAC
ptg000756l polypolish	reverse	AGGGTTAGGGTTAGGGTTAGGGTTAGGGTTAGGGTTAGGGTTAGGGTTAGGGTTAGAGGGCAATACGTAACTGAACGAAGCACTAGGATAGAGCAACATA
ptg000758l polypolish	reverse	AGGGTTAGGGTTAGGGTTAGGGTTAGGGTTAGGGTTAGGGTTAGGGTTAGGGTTAGGGTTAGCCTTAGGGTTAGGCTTACCGTAAGGGTAGCCATACTGA
ptg000767l polypolish	reverse	TTAGGGTTAGGGTTAGGGTTAGGGTTAGGGTTAGGGTTAGGGTTAGGGTTAGGGTTAGGGTTAGGGTTAGGGTTAGGGTTAGGGTTAGGGCAATACGTAG
ptg000770l polypolish	reverse	GTTAGGGTTAGGGTTAGGGTTAGGGTTAGGGTTAGGGTTAGGGTTAGGGTTAGGGTTAGGGTTAGGGTTAGGGTTAGGGTTAGGGTTAGCATTAGGGTTA
ptg000777l polypolish	forward	TAACCCTAACCCTAACCCTAACCCTAACCCTAACCCTAACCCTAACCCTAACCCTAACCCTAACCCTAACCCTAACCCTAACCCTAACCCTAACCCTAAC
ptg000781l polypolish	reverse	GGTTAGGGTTAGGGTTAGGGTTAGGGTTAGGGTTAGGGTTAGGGTTAGGGTTAGGGTTAGGGTTAGGGTTAGGGTTAGGGTTAGGGTTAGGGTTAGGGTG
ptg000787l polypolish	reverse	GGGTTAGGGTTAGGGTTAGGGTTAGGGTTAGGGTTAGGGTTAGGCAGTAGGTTGCATTAGGGACAATAGTTTAACTGAATCCAAGGTAGTACACATAAAC
ptg000788l polypolish	forward	TTAACCCTAACTCTACTAAATTGTCTAACCCTATCCCTAACCCTAACCCTAACCCTAACGGTAACCCTAACCCTAACGCCTAACCCTACCCTAACCCTAA
ptg000790l polypolish	reverse	GGTTAGGGTTAGGGTTAGGGTTAGGGTTAGGGTTAGGGTTAGGGTTAGGGTTAGGGTTAGGGTAGTAACTGAACTAAACTGACATAGGCAGAGTGGTACA
ptg000796l polypolish	forward	ATTTGTGTAACCTACTTAAGCTAGATCTAGTATATGCTCCTAACCCTAACCCTAACCCTAACCCTAACCCTAACCCTAACCCTAACCCTAACCCTAACCC
ptg000798l polypolish	reverse	TTAGGGTTAGGGTTAGGGTTAGGGTTAGGGTTAGGGTTAGGGTTAGGGTTAGGGTTAGGGTTAGGGTTAGGAGCAATACGTAACTGAACGAGTAGGTTAC
ptg000809l polypolish	forward	TGTTATGTCCATCTACTAAGACTAAGTAAGTCTACCCTAACCCTAACCCTAACCCTAACCCTAACCCTAACCCTAACCCTAACCCTAACCCTAACCCTAA
ptg000816l polypolish	forward	CTTAGTATGTCTAACCCTAACCTTATTACCCTAACCCTAACCCTAACCCTAACCCTAACCCTAACCCTAACCCTAACCCTAACCCTAACCCTAACCCTAA
ptg000817l polypolish	forward	AGTAGCCCTGGAACAGTTACATTATTGTCCCTAACCCTAACCCTAACCCTAACCCTAACCCTAACCCTAACCCTAACCCTAACCCTAACCCTAACCCTAA
ptg000823l polypolish	reverse	TTAGGGTTAGGGTTAGGGTTAGGGTTAGGGTTAGGGTTAGGGTTAGGCTTAGGGTTAGGGTTAGGGTTAGGGTTAGGGTTAGGGTTAGGGTTAGGGTTAG
ptg000824l polypolish	reverse	GGGTTAGGGTTAGGGTTAGGGTTAGGGTTAGGGTTAGGGTCTAGGGTTAGGGTCAGGGTTAGGGTTAGGGTTAGGGTTAGGGTTAGGGGCAATGCGTAAG
ptg000827l polypolish	forward	TGTTTATGCCTGCCTGACTAGGTTCAGGGTTAGTATACTCCATAACCCTGAACCCTAACCCTAACCCTAACCCTAACCCTAACACCAACCCTAACCCTAA
ptg000827l polypolish	reverse	GGGTTAGGGTTAGGGTTAGGGTTAGGGTTAGGGTTAGGGTTAGGGTTAGGGTTAGGGTTAGGGTTAGGGTTAGGGTTAGGGTTAGGGTTAGGGTTAGGGT
ptg000834l polypolish	reverse	GGTTAGGGTTAGGGTTAGGGTTAGGGTTAGGGTTAGGGTTAGGGTTAGGGTTAGGGTTAGGGTTAGCATATGCGTTAGGGTTAGGGTAGCAATTAGAGTA
ptg000852l polypolish	forward	ACCCTAACCCTAACCCTAACCCTAACCCTAACCCTAACCCTAACCCTAACCCTAACCCTAACCCTAACCCTAACCCTAACCCTAACCCTAACCCTAACCC
ptg000871l polypolish	reverse	TTAGGGTTAGGGTTAGGGTTAGGGTTAGGGTTAGGGTTAGGGTTAGGGTTAGGGTTAGGGTTAGGGTTAGGGTTAGGGTTAGGGTTAGGGTTAGGGTTTG
ptg000872l polypolish	reverse	TAGGGTTAGGGTTAGGGTTAGGGTTAGGGTTAGGGTTAGGGTTAGGGTTAGGGTTAGGGTTAGGGTTAGGGTTCAATAGGGTTAGGGTTAGGGTTAGGGT
ptg000873l polypolish	reverse	TTAGGGTTAGGGTTAGGGTTAAGTTAGGGTACCAGGGTTAGGGTTAGGGTTAGCCATAGGTGTAACTGAACCTAACTGAGTCCATTAGCAGATAATATAC
ptg000882l polypolish	forward	CTTGCTAACCTAGTAACTAATTACTATTACCTTCATAACCCTACTAGTTCCTAGACCCTACCCTAACCCTAACCTAACCCTAAGCCCTAAACCCTAACCC
ptg000886l polypolish	reverse	GGGTTAGGGTTAGGGTTAGGGTTAGGGTTAGGGTTAGGGTTAGGGTTAGGGTTAGGGTTAGGGTTAGGGTTAGGGACAGGTGTAGGGGCTTAGTTAGTGA
ptg000890l polypolish	forward	TAACCCTAACCCTAACCCTAACCCTAACCCTAACCCTAACCCTAACCCTAACCCTAACCCTAACCCTAACCCTAACCCTAACCCTAACCCTAACCCTAAC
ptg000894l polypolish	reverse	GGTTAGGGTTAGGGTTAGGGTTAGGGTTAGGGTTAGGGTTAGGGTTAGGGTTAGGGTTAGGGTTAGGGTTAGGGAGCATAGGGTAACTGAACTAGAGTTA
ptg000895l polypolish	forward	ATGTCTCTCTTGGTTCAGTTCACCCTATTGCTAACCCTAACCCTAACCCTAACCCTAACCCTAACCCTAACCCTAACCCTAACCCTAACCCTAACCCTAA
ptg000902l polypolish	reverse	AGGGTTAGGGTTAGGGTTAGGGTTAGGGTTAGGGTTAGGGTTAGGGTTAGGGTTAGGGTTAGGGTTAGGGTTAGGGTTAGGGTTAGGTGGTTAGGGTTAG
ptg000912l polypolish	reverse	GGTTAGGGTTAGGGTTAGGGTTAGGGTTAGGGTTAGGGTTAGGGTTAGGGTTAGGGTTAGGGTTAGGGATGTAATGTAGGGTTAGGCTTAGGCATAAACA
ptg000919l polypolish	reverse	TTCAGTTTCCTTTTAGCCATAGCTGCTGACATTGTCATTTAGGGGTTAGGGTTAGGGTTAGGGTTAGGGGGATGATAAACACCAGTAGGCTAATAGATAT
ptg000921l polypolish	reverse	GTTAGGGTTAGGGTTAGGGTTAGGGTTAGGGTTAGGGTTAGGGTTAGGGTTAGGGTTAGGGTTAGGGTTAGGGTTAGGGTTAGGGTTAGGGTTAGGGTTA
ptg000924l polypolish	forward	TAGTTAGCCTAACCGATAACCCTAACCCTAACCCTAACCCTAACCCTAACCCTAACCCTAACCCTAACCCTAACCCTAACCCTAACCCTAACCCTAACCC
ptg000926l polypolish	reverse	GTTAGGGTTAGGGTTAGGGTTAGGGTTAGACCTAGGGTTAGGGTTAACCGTTAGAGAGAGGGTTAGACATAGCGTTAGAACTCAGGTAAATATGAACAGT
ptg000944l polypolish	forward	ACGTATTGCTAACCCTAACCCTAACCCTAACCCTAACCCTAACCCTAACCCTAACCCTAACCCTAACCCTAACCCTAACCCTAACCCTAACCCTAACCCT
ptg000962l polypolish	forward	GCTAACCCTAACCCTAACCCTAACCCTAACCCTAACCCTAACCCTAACCCTAACCCTAACCCTAACCCTAACCCTAACCCTAACCCTAACCCTAACCCTA
ptg000964l polypolish	forward	CTATAACTAACATTGCTGTAAGGTATGTTTGAAAGTTTGGGGAGTTTTGGAGACATTTTGAGCAAATGGGAGAATTAATAAAAGTAATAGAATTCTTTGA
ptg000980l polypolish	reverse	GTTAGGGTTAGGGTTAGGGTTAGGGTTAGGGTTAGGGTTAGGGTTAGGGTTAGGGTTAGGGTTAGGGTTAGGGTTAGGGTTAGGGTTAGGGTTAGGGTTA
ptg000984l polypolish	reverse	GTTAGGGTTAGGGTTAGGGTTAGGGTTAGGGTTAGGGTTAGGGTTAGGGTTAGGGTTAGGGTTAGCAATAGACATGTAGGCTTAGGCATTAGGGTTACAT
ptg000986l polypolish	forward	ACTTGGTTCAGTTCGTATAGTGCTGCTAACCCTAACACCCTAACCCTAACCCTAACCCTAATGCCTAACCCTATTGGTAATCTTATATTGCCCTAACCCT
ptg000993l polypolish	forward	CTAACCCTAACCCTAACCCTAACCCTAACCCTAACCCTAACCCTAACCCTAACCCTAACCCTAACCCTAACCCTAACCCTAACCCTAACCCTAACCCTAA
ptg001001l polypolish	forward	TGTTTATGTGTGCCTAACTAGACTACGCATTGGTCTAACCCTAAACTAATGTCTAAGTTAACATAACCTAATCTAACCCTAACCCTACCCTAACCCTAAC
ptg001007l polypolish	forward	TGTGACCAACTATTTCGGTTAATTGCTCATATGACTAACCCTAACCCTAACCCTAACCCTAAGCCCTAACCCTAACCCTAACCCTAACCCTAACCCTAAC
ptg001008l polypolish	forward	ATGTCTATGTGCCTGTACTTCGTCAGTTCTGCTATATGCTAACCCTAACCCTAACCCTAACCCTAACCCTAACCCTAACCCTAACCCTAACCCTAACCCT
ptg001010l polypolish	reverse	GTTAGGGTTAGGGTTAGGGTTAGGGTTAGGGTTAGGGTTAGGGTTAGGGTTAGGGTTAGGGTTAGGGTTAGGGTTAGGGTTAGGGTTAGGGTTAGGGTTA
ptg001014l polypolish	forward	AACCCTAACCCTAACCCTAACCCTAACCCTAACCCTAACCCTAACCCTAACCCTAACCCTAACCCTAACCCTAACCCTAACCCTAACCCTAACCCTAACC
ptg001020l polypolish	reverse	TAGGGTTAGGGTTAGGGTTAGGGTTAGGGTTAGGGTTAGGGTTAGGGTTAGGGTTAGGGTTAGGGTTAGGGTTAGGGTATGAACAAGTAAGTTAGACATA
ptg001026l polypolish	forward	TAACCCTAACCCTAACCCTAACCCTAACCCTAACCCTAACCCTAACCCTAACCCTAACCCTAACCCTAACCCTAACCCTAACCCTAACCCTAACCCTAAC
ptg001027l polypolish	reverse	GGGTTAGGGTTAGGGTTAGGGTTAGGGTTAGGGTTAGGGTTAGGGTTAGGGTTAGGGTTAGGGATTAGGGTTAGGAATTAGGGTTAGGGTTAGGGTTTTG
ptg001028l polypolish	forward	ATGTACCTACTACCCTAAGTCTAAGCCTAACCCTAACCCTATCCTAACCCTAACCCTAACTCCTAACCCTAACCCTAACCCTAACCCTAACCCTAACCCT
ptg001029l polypolish	reverse	TAGGGTTAGGGTTAGGGTTAGGGTTAGGGTTAGGGTTAGGCCCTTAGTGGTTAGAATGGTTACGTAGCAATACGTAACGAACCAGTGGCTCACATAAAAT
ptg001034l polypolish	forward	ATGTAACCCTACCTTGGACCCATCGTATTGCTCTAACCCTATGTCACCCTAAGCCCTAACCCTTACCCTAACCCTAACCCTAACCCTAACCCTAACCGTA
ptg001055l polypolish	forward	TAACCCTAACCCTAACCCTAACCCTAACCCTAACCCTAACCCTAACCCTAACCCTAACCCTAACCCTAACCCTAACCCTAACCCTAACCCTAACCCTAAC
ptg001064l polypolish	reverse	TTAGGGTTAGGGTTAGGGTTAGGGTTAGGGTTAGGGTTAGGGTTAGGGTTAGGGTTAGGGTTAGGGTTAGGGTGTAGGGTTAGGGAGACCAGGGTTATAT
ptg001068l polypolish	forward	CCTAACCCTAACCCTAACCCTAACCTAACCCTGTACCCTAACCCTAACCCTAACCCTAACCCTAACCCTAACCCTAACCCTAACCCTAACCCTAACCCTA
ptg001079l polypolish	forward	AAATGCATTGCTCTAACCCTAACCCTAACCCTAACCCTAACCCTAACCCTAACCCTAACCCTAACCCTAACCCTAACCCTAACCCTAACCCTAACCCTAA
ptg001084l polypolish	reverse	GGTTAGGGTTAGGGTTAGGGTTAGGGTTAGGGTTAGGGTTAGGGTTAGGGTTAGGGTTAGGGTTAGGGTTAGGGTTAGGAGCAGATAGGGTTGAGGTAGT
ptg001086l polypolish	forward	TAACCCTACCCTAACCCTAACTACTAACTCTAGTATACCCTAACCCTAACCCTAACCCTAACCCTAACCCTAACCCTAACCCTAACCCTAACCCTAACCC
ptg001088l polypolish	reverse	GTTAGGGTTAGGGTTAGGGTTAGGGTTAGGGTTAGGGTTAGGGTTAGGGTTAGGGTTAGGGTTAGGGTTAGGGTTAGGGTTAGGGTTAGGGTTAGGGTTA
ptg001093l polypolish	reverse	TTAGGGTTAGGGTTAGGGTTAGGGTTAGGGTTAGGGTTCAATCTTAGGGTTAGGGTTACACTTACTTAGGTAGGAGCATAGATGTATCTGTAGATAGTAT
ptg001095l polypolish	forward	AACCCTAACCCTAACCCTAACCCTAACCCTAACCCTAACCCTAACCCTAACCCTAACCCTAACCCTAACCCTAACCCTAACCCTAACCCTAACCCTAACC
ptg001107l polypolish	forward	AGACTTAAACCTAACCCTAACCCTATCCCTAACCCTAAGAGGTAACCCTAACCCTAACTTCTGACCCTAACACTAATAATCCTAATCCCTATGTTTCGCT
ptg001114l polypolish	reverse	GGGTTAGGGTTAGGGTTAGGGTTAGGGTTAGGGTTAGGGTTAGGGTTAGGGTTAGGGTTAGGGTTAGGGATTAATACGTGAAAAGAGATAACATAAAGAT
ptg001115l polypolish	forward	CTAACCCTAACCCTAACCCTAACCCTAACCCTAACCCTAACCCTAACCCTAACCCTAACCCTAACCCTAACCCTAACCCTAACCCTAACCCTAACCCTAA
ptg001120l polypolish	forward	TATCTACCACCTATGGTTCAGGACATCTATCCCTCGAGCTAACGTCTCCTAACCCTAACCCTAACCCTAACCCTAACCCTAACCCTAACCCTAACCCTAA
ptg001131l polypolish	forward	CCCTAATGCCCTAACCCTAACCCTAACCCTAACCCTAACCCTAACCCTAACCCTAACCCTAACCCTAACCCTAACCCTAACCCTAACCCTAACCCTAACC
ptg001169l polypolish	forward	ATGTTATGCCTAACCATTACACCACCATTGCTCTAACCCTAACCCTAACCCTAACCCTAACCCTAACCCTAACCCTAACCCTAACCCTAACCCTAACCCT
ptg001183l polypolish	forward	CTACGTATTGCTCCCTAACCCTAACCCTAACCCTAACCCTAACCCTAACCCTAACCCTAACCCTAACCCTAACCCTAACCCTAACCCTAACCCTAACCCT
ptg001191l polypolish	forward	CCTAACCCTAACCCTAACCCTAACCCTAACCCTTTACTCTCTCTCTCCAATTTCCCTAACCCATGCTCAGATCCTTTTTTTCACTTCACCCCTGGGATAT
ptg001194l polypolish	reverse	GGTTAGGGTTAGGGTTAGGGTTAGGGTTAGGGTTAGGGTTAGGGTTAGGGTTAGGGTTAGGGTTAGGGTTAGGGTTAGGGTTAGGGTTAGGGTTAGGGTT
ptg001197l polypolish	reverse	GGGTTAGGGTTAGGGTTAGGGTTAGGGTTAGGGTTAGGGTTAGGGTTAGGGTTAGGGTTAGGGTTAGCACGGTTAGGGTTAGGGCCTTAGGGCCAAAACT
ptg001200l polypolish	forward	CTAACCCTAACCCTAACCCTAACCCTAACCCTAACCCTAACCCTAACCCTAACCCTAACCCTAACCCTAACCCTAACCCTAACCCTAACCCTAACCCTAA
ptg001201l polypolish	forward	TAACGCTACCTAACCTTATCCTGAAACACCTAACCCTAACCCTAACCCTAACCCTAACCCTAACCTAACCCTAACCCTAACCCTAACCCTAACCCTAACC
ptg001221l polypolish	reverse	GGGTTAGGGTTAGGGTTAGGGTTAGGGTTAGGGTTAGGGTTAGGGTTAGGGTTAGGGTTAGGGTTAGGGTTAGGGTTAGGGTTAGGGTTAGGGTTAGGGT
ptg001227l polypolish	forward	CACCATTGCTCCTAACCCTAACCCTAACCCTAACCCTAACCCTAACCCTAACCCTAACCCTAACCCTAACCCTAACCCTAACCCTAACCCTAACCCTAAC
ptg001232l polypolish	forward	AACTAGCCCTAACAGCTAACCTAACCCTAACCCTAACCCTAACCCAACCCTAACCCTAACCCTACCCTAACCCACCCTAACAGCCTAGTCCCTAGACCTA
ptg001235l polypolish	reverse	GGTTAGGGTTAGGGTTAGGGTTAGGGTTAGGGTTAGGGTTAGGGTTAGGGTTAGGGTTAGGGTTAGGGTTAGGGTTAGGGTTAGGGTTAGGGTTAGCCAT
ptg001237l polypolish	reverse	GGGTTAGGGTTAGGGTTAGGGTTAGGGTTAGGGTTAGGGTTAGGGTTAGGGTTAGGGTTAGGGTTAGGGTAGTATATGTAACTGAACCAGTAGTTAGCAT
ptg001251l polypolish	reverse	AGGGTTAGGGTTAGGGGCAATTACGTGATAGGATGCCTTAGTTTCACCGTAAGGGTAATCTGCTATGACTGATAGCTGTTAGCTAATGAACCGTACACAC
ptg001255l polypolish	forward	CCTAACCCTAACCCTAACCCTAACCCTAACCCTAACCCTAACCCTAACCCTAACCCTAACCCTAACCCTAACCCTAACCCTAACCCTAACCCTAACCCTA
ptg001263l polypolish	reverse	TTAGGGTTAGGGTTAGGGTTAGGGTTAGGGTTAGGGTTAGGGTTAGGGTTAGGGTTAGGGTTAGGGTTAGGGTTAGGGTTAGGGTGTAAGGGTTATAGGA
ptg001264l polypolish	reverse	GGTTAGGGTTAGGGTTAGGGTTAGGGTTAGGGTTAGGGTTAGGGTTAGGGTTAGGGTTAGGGTTAGGGTTAGGGTTAGGGTTAGGGTTAGGGTTAGGGTT
ptg001265l polypolish	forward	CTAACCAATCACCCCTAACCCTAACCCTAACCCTAACCCTAACCCTAACCCTAACCCTAACCCTAACCCTAACCCTAACCCTAACCCTAACCCTAACCCT
ptg001269l polypolish	forward	AACCCTAACCCTAACCCTAACCCTAACCCTAACCCTAACCCTAACCCTAACCCTAACCCTAACCCTAACCCTAACCCTAACCCTAACCCTAACCCTAACC
ptg001280l polypolish	reverse	TAGGGTTAGGGTTAGGGTTAGGGTTAGGGTTAGGGTTAGGGTTAGGGTAGGGTTAGGGTTAGGGTTAGGGTTAGGGACAATAGGGTAATAGGGTTAGGGT
ptg001285l polypolish	reverse	GGGTTAGGGTTAGGGTTAGGGTTAGGGTTAGGGTTAGGGTTAGGGTTAGGGTTAGCATTAGGGTTAGGAGTAGATCAGCTTATCTTAGCTAAGCTTACAT
ptg001306l polypolish	reverse	TAGGGTTAGGGTTAGGGTTAGGGTTAGGGTTAGGGTTAGGGTTAGGGTTAGGGTTAGGGTTAGGGTTAGGGTTAGGGTTAGGGTTAGGGTTAGGGTTAGG
ptg001307l polypolish	reverse	GTTAGGGTTAGGGTTAGGGTTAGGGTTAGGGTTAGGGTTAGGGTTAGGGTTAGGGTTAGGGTTAGGGTTAGGGTTAGGGTTAGGGTTAGGGTTAGGGTTA
ptg001315l polypolish	reverse	GGTTAGGGTTAGGGTTAGGGTTAGGGTTACGGTAGTGTTAGGGTTAGTATTAGGTGTTAGGGACAATATATAGACGTAATCTGAACCATGGTACAGTCAT
ptg001333l polypolish	reverse	GGGTTAGGGTTAGGGTTAGGGTTAGGGTTAGGGTTAGGGTTAGGGTTAGGGTTAGGGTTAGGGTTAGGGTTAGGGTTAGGGTTAGGGTTAGGGTTAGGGT
ptg001334l polypolish	reverse	TAGGGTTAGGGTTAGGGTTAGGGTTAGGGTTAGGGTTAGGGTTAGGGTTAGGGTTAGGGTTAGGGTTAGGGTTAGGGTTAGGGTTAGGGTTAGGGTTAGG
ptg001335l polypolish	reverse	GTTAGGGTTAGGGTTAGGGTTAGGGTTAGGGTTAGGGTTAGGGTTAGGGTTAGGGTTAGGGTTAGGGTTAGGGTTAGGGTTAGGGTTAGGCAGTGCGTTG
ptg001337l polypolish	reverse	GGGTTAGGGTTAGGGTTAGGGTTAGGGTTAGGGATAGGGTTAGGGTTAGGGTTAGGAATAAGTAGGTGAACCAGGCTCATAAGCGATCAGAAGTAGGGTT
ptg001340l polypolish	forward	ACTACTTATCATAATTCACTAGCCCTTTCAGTGACCCTCCCATTTTGATACAATGGCAGTACACCTAATAAGCTTTTTCCCGTATACATTAACCCTAACC
ptg001359l polypolish	forward	CCGAACCCTAACCTTAACCCTACCCTAAACCCTAACCCTAACCCTAACCCTAACCCTAACCCTAACCCTAACCCTAACCCTAACCCTAACCCTAACCCTA
ptg001363l polypolish	reverse	GGGTTAGGGTTAGGGTTAGGGTTAGGGTTAGGGTTAGGGTTAGGGTTAGGGTTAGGGTTAGGGTTAGGGTATAGTGTAACTGAAGCGAGAGACTTACACT
ptg001406l polypolish	reverse	GGTTAGGGTTAGGGTTAGGGTTAGGGTTAGGGTTAGGGTTAGGGTTAGGGTTAGGGTTAGGGTTAGGGTTAGGGTTAGGGTTAGGGTTAGGGTTAGGGTT
ptg001417l polypolish	forward	CTAACCCTAACCCTAACCCTAACCCTAACCCTAACCCTAACCCTAACCCTAACACCTAACCCTAACCCTAACCCTAACCCTAACCCTAACCCTAACCCTA
ptg001418l polypolish	reverse	AGGGTTAGGGTTAGGGTTAGGGTTAGGGTTAGGGTTAGGGTTAGGGTTAGGGTTAGGGTTAGGGTTAGGGTTAGGGTTAGGGTTAGGGTTAGGGTTAGGG
ptg001421l polypolish	reverse	AGGGTTAGGGTTAGGGACTAGGGTCCTAGGGTCCTAGGGTTAGGGTTATCGGTAAGCCGGTTAGGGTAGTATTGTCTAATGAACCTGACCTTCCAGGGTA
ptg001425l polypolish	reverse	GTTAGGTTAGGGTTAGGGTTAGGGTTAGGGTTAGGGTTAGGGTTAGGGTTAGGTTAGCCCGTTAGGATTAGGGTTAGGGTTAGGGATAGGGTTAGGGTTT
ptg001434l polypolish	reverse	GGGTTAGGGTTAGGGTTAGGGTTAGGGTTAGGGTTAGGGTTAGGGTTATGTAGGGTTAGGGTTAGAGCATACCTAACTAGAACGAGTAGGTTACATCACT
ptg001435l polypolish	forward	TATGCCCTGTACTGTTCAGTTACGTATTTCCCTAACCCTAACCCTAACCCTAGCCTAACCCTAACCCTAACCCTAACCCTAACCCTAACCCTAACCCTAA
ptg001473l polypolish	reverse	AGGGTTAGGGTTAGGGTTAGGGTTAGGGTTAGGGTTAGGGTTAGGGTTAGGGTTAGGGTTAGGGTTAGGGTTAGGGTTAGGGTTAGGGTTAGGGTTAGGG
ptg001475l polypolish	forward	CTCAGCCTATTGCTCCCTAACCCTAACCCTAACCCTAACCCTAACCCTAACCCTAACCCTAACCCTAACCCTAACCCTAACCCTAACCCTAACCCTAACC
ptg001478l polypolish	reverse	AATAGCAGCATAGGGTTAGGTTAGTTAGGGTTAGGGTTAGGGTTAGGCAGTTAGGGTTAGGGTTAGGGTTAGGGTTAGGGTTAGGGTGCAATTGGTGAGC
ptg001500l polypolish	reverse	GGTTAGGGTTAGGGTTAGGGTTAGGGTTAGGGTTAGGGTTAGGGTTAGGGTTAGGGTTAGGGTAGCAATACGTAACTGAACGAAGTAAGGTGTAGGCATA
ptg001507l polypolish	forward	GTTTATGTGTAACCTACTCAACATCATATACTACTAACCCTAACCCTAAACCCTAACCCTAACCCTAACCCTAACCCTAACCCTAACCCTAACCCTAACC
ptg001516l polypolish	forward	ATGTGGCCTTGCAGTTAGGATTTCCCTAACCCTAACCCTAACCCTAACCCTAACCCTAACCCTAACCCTAACCCTAACCCTAACCCTAACCCTAACCCTA
ptg001519l polypolish	reverse	TAGGGTTAGGGTTAGGGTTAGGGTTAGGGTTAGGGTTAGGGTTAGGGTTAGGGTTAGGGTTAGGGTTAGGGTTAGGGTTAGGGTTAGGGTAGCAATTAGA
ptg001527l polypolish	reverse	GTTAGGGTTAGGGTTAGGGTTAGGGTTAGGGTTAGGGTTAGGGTTAGGGTTAGGGTTAGGGTTAGGGTTAGGGTTAGGGTTAGGGTTAGGGTTAGGGTTA
ptg001530l polypolish	forward	CCCTAACTCCTAACCCTAACCCTAACCCTAACCCTAACCCTAACCCTAACCCTAACCCTAACCCTAACCCTAACCCTAACCCTAACCCTAACCCTAACCC
ptg001532l polypolish	reverse	TAGGGTTAGGGTTAGGGTTAGGGTTAGGGTTAGGGTTAGGGTTAGGGTTAGGGTTAGGGTTAGGGTTAGGGTTAGGGTTCCGCCCCTTAGGGCAATTTAG
ptg001535l polypolish	reverse	AGGGTTAGGGTTAGGGTTAGGGTTAGGGTTAGGGTTAGGGTTAGGGTTAGGGTTAGGGTTAGGGTTAGGGTAGCAATACTGTAAGGATAAGGCAGGTATA
ptg001536l polypolish	forward	ATTATTGCCTAGACCTCCCTACCCTGAACCCTAACCCTAACCCTAACGGCTAACCCTAACCCTGGAACCCTAACCCTATTGCCTAACCCTAACCCTAACC
ptg001538l polypolish	reverse	GGTTAGGGTTAGGGTTAGGGTTAGGGTTAGGGTTAGGGTTAGGGTTAGGGTTAGGGTTAGGGTTAGGGTTAGGGTTAGGGTTAGGGTTAGGGTTAGGGTT
ptg001548l polypolish	forward	CCCTATTCCCTAACCCTAACCCTAACCCTAACCCTAACCCTAACCCTAACCCTAACCCTAACCCTAACCCTAACCCTAACCCTAACCCTAACCCTAACCC
ptg001554l polypolish	reverse	GTTAGGGTTAGGGTTAGGGTTAGGGTTAGGGTTAGGGTTAGGGTTAGGGTTAGGGTTAGGGTTAGGGTTAGGGTTAGGGTTAGGGTTAGGGCGATTAGTG
ptg001560l polypolish	forward	CTAACCCTAACCCTAACCCTAACCCTAACCCTAACCCTAACCCTAACCCTAACCCTAACCCTAACCCTAACCCTAACCCTAACCCTAACCCTAACCCTAA
ptg001566l polypolish	reverse	TTAGGGGTTAGGGTTACGGTTAGAATCCAGGGTAAGGGTTAGGGTTAGGGTTAGGGTTAGGGTTGGTCAGCAATACGTGGACTGAACGAGTAACCTAGGC
ptg001570l polypolish	reverse	GGTTAGGGTTAGGGTTAGGGTTAGGGTTAGGGTTAGGGTTAGGGATTAGGGTTAGGGTAGCAATACACGTAATGGAACCAGTAGGGTTACACATAAACAT
ptg001581l polypolish	forward	GTTTATGCATGTTACTTGGTTCATGTTTACGTATTGCTAACCCTAACCCTAACCCTAACCCTAACCCTAACCCTAACCCTAACCCTAACCCTAACCCTAA
ptg001582l polypolish	forward	ACTGAACTACTTCTTCGTTTTGTACTTCTCTTTAACCTAACTTATATTGTAATAATTCAAATTGTGCTTTAACTAAAGGTTTGGTTAATATATCAGCAAT
ptg001597l polypolish	reverse	TAGGGTTAGGGTTAGGGTTAGGGTTAGGGTTAGGGTTAGGGTTAGGGTTAGGGTTAGGGTTAGGGTTAGGGTTAGGGTTAGGGTTAGGGTTAGCATCTAG
ptg001606l polypolish	reverse	GGGTTAGGGTTAGGGTTAGGGTTAGGGTTAGGGTTAGGGTTAGGGTTAGGGTTAGCAATTAGGGTTAGGGTTAGGGTTAGGGTTAGGAGCAATTGGTCAG
ptg001608l polypolish	forward	ACAACTAATTCCTAACCCTAACCCTAACCCTAACCCTAACCCTAACCCTAACCCTAACCCTAACCCTAACCCTAACCCTAACCCTAACCCTAACCCTAAC
ptg001614l polypolish	forward	TGTTATGTAAGCCTACCTTGACTCATACATATACTACCCTAACCCTAACATCCTAACCCTAACCCTAACCCTAACCCTAACCCTAACCCTAACCCTAACC
ptg001617l polypolish	reverse	TTAGGGTTAGGGTTAGGGTTAGGGTTAGGGTTAGGGTTAGGGTTAGGGTTAGGGTTAGGGTTAGGGTTAGGGTTACCAATACCTTCTTTAGACTTAGGTG
ptg001628l polypolish	reverse	TTAGGGTTAGGGTTAGGGTTAGGGTTAGGGTTAGGGTTAGGGTTAGGGTTAGGGTTAGGGAGCAATACGGAACTAATGAACCAGAGGGCACACATAAACT
ptg001662l polypolish	forward	ATATTCACTCACCTAACTCGATTCCCTAAGCCTAACCCTAACCCTAACCCTAACCCTAACCCTAACCCTAACCCTAACCCTAACCCTAACCCTAACCCTA
ptg001668l polypolish	forward	TAGCCTTGTTCAGTTAGGTATGCTCCCTAACCCTAACCCTAACCCTAACCCTAACCCTAACCCTAACCCTAACCCTAACCCTAACCCTAACCCTAACCCT
ptg001673l polypolish	forward	ACCCTAACCCTAACCCTAACCCTAACCCTAACCCTAACCCTAACCCTAACCCTAACCCTAACCCTAACCCTAACCCTAACCCTAACCCTAACCCTAACCC
ptg001675l polypolish	forward	AACCCTAACCCTAACCCTAACCCTAACCCTAACCCTAACCCTAACCCTAACCCTAACCCTAACCCTAACCCTAACCCTAACCCTAACCCTAACCCTAACC
ptg001678l polypolish	forward	GTGATTCAAAATTTTGCAGTTCATGTCGCATTGAATTGTACCTATTCCCCAAATGAAGAAAAATAACTAACAATATGGATAGTGTGGCGTTGTTGTAGTT
ptg001682l polypolish	reverse	TTAGGGTTAGGGTTAGGGTTAGGGTTAGGGTTAGGGTTAGGGTTAGGGTTAGGGTTAGGGTTAGGGTTAGGGTTAGGGTTAGGGTTAGGGTTAGGGTTAG
ptg001687l polypolish	forward	GTGACCTCTGGATTCGGTAATCAGAATGGCCTTACTCTAACCCTAACCCTAACCCTAACCCTAACCCTAACCCTAACCCTAACCCTAACCCTAACCCTAA
ptg001689l polypolish	forward	GACACTACAGAGTTGTAGTGCTCTACCAGCTATTGAACCCTAGCTAACCAGTAACCCTAACCCTAACCCTAACCCTAACCCTAACCCTAACCCTAACCCT
ptg001694l polypolish	reverse	GGTTAGGGTTAGGGTTAGGGTTAGGGTTAGGGTTAGGGTTAGGGTTAGGGTTAGGGTTAGGGTTAGTTGGAGCAGTTAGACGTACGCAATGGAGGGATAA
ptg001701l polypolish	forward	TAGCCCTAAACCCTCAACCCTAACCCTAACCCTAACCCTAACCCTAACCCTAACCCTAACCCTAACCCTAACCCTAACCCTAACCCTAACCCTAACCCTA
ptg001716l polypolish	forward	TTTTTATGCCTGACTTCGTTCTTACGTATTGCTGAACTATCTACTAAACGTTCAGTTACGTATTGCTTACGCCCTAACCCTAACCCTAACCCTAACCCTA
ptg001749l polypolish	forward	ACGCTATGGGACTACTTACCCTAACCCTAACCCTAACCCTAACCCTAACCCTAACCCTAACCCTAACCCTAACCCTAACCCTAACCCTAACCCTAACCCT
ptg001759l polypolish	reverse	AGGGTTAGGGTTAGGGTTAGGGTTAGGGTTAGGGTTAGGGTTAGGGTTAGGGTTAGGGTTAGGGCAATAGGGTTAGGGTTAAACACCAGGCAGACTAACA
ptg001777l polypolish	forward	ACCTCTAACCCTAACCCTAACCACTAACCCTAACCCTAACCCTAACCCTAACCCTAACCCTAACCCTAACCCTAACCCTAACCCTAACCCTAACCCTAAC
ptg001781l polypolish	reverse	GGGTTATGTGAATAGGGTTAGGGTTAGGGTTAGGGTTAGGGTTAGGGTTAGGGTTAGGGTTAGGGTTAGGGTTAGGGTTAGGGTTAGGGAGAATAGGTAA
ptg001791l polypolish	forward	CTGTAGTCTACTTCGCTCAGTTATATTGCTCCTAACCCTAATCCTACCCTAACCCTAACCCTAACCCTAACCCTAACCCTAACCCTAACCCTAACCCTAA
ptg001808l polypolish	reverse	TAGGGTTAGGGTTAGGGTTAGGGTTAGGGTTAGGGTTAGGGTTAGGGTTAGGGTTAGGGTTAGGGTAGCAATACCTAACTGAACCAGTAGGGTTACATAA
ptg001817l polypolish	forward	TATGAACCAGTAGGCAGGCATAAGATTACGTATTGCTACCTCCCTAACACTAACCCTTAGCCTAACCCTAACCCTATCCCTAACCCTAACCCTAACCCTA
ptg001824l polypolish	forward	AACTGCTTGATATTTCAAGTTCGATTAGCTTTTCATCCTTACCACAATTCATTACGGTATCTATAGTCCCTAACCCTAACCCTAACCCTAACCCTAACCC
ptg001834l polypolish	forward	TATGCTAGGGCCTTTCGTCAGTTACGTATTGCCCTCCTAACCCTAACCCTAACCCTAACCCTAACCCTAACCCTAACTGTAACCCTAACCCTAACCCTAA
ptg001855l polypolish	reverse	TTAGGGTTAGGGTTAGGGTTAGGGTTAGGGTTAGGGTTAGGGTTAGGGTTAGGGTTAGGGTTAGGGTTAGGGTTAGGGTTAGGGCAATGTGAGCCTGATT
ptg001869l polypolish	forward	TAACCCTAACCCTAACCCTAACCCTATTGCTAACCCTAACCCTAACCCTAACCCTAACCCTAACCCTAACCCTAACCCTAACCCTAACCCTAACCCTAAC
ptg001875l polypolish	forward	GTTTGATACTAGCCCACCAGTATTATCCCTAACCCTAACCCTAACCCTAACCCTAACCCTAACCCTAACCCTAACCCTAACCCTAACCCTAACCCTAACC
ptg001881l polypolish	forward	TAGTGCATACTTGGTTCAGTTACGTATAGCTCCCTAACCCTACCCTAACCATTAGCCTAACCTAACCCTAACCCTGTAACCCTAACCCTAACCGTAACCC
ptg001908l polypolish	forward	ACTAACCCTAACCCTAACCCTAACCCTAACCCTAACCCTAACCCTAACCCTAACCCTAACCCTAACCCTAACCCTAACCCTAACCCTAACCCTAACCCTA
ptg001911l polypolish	forward	ATGTGTGCCTCAATTCAGTTACCCTAGACCCTAACCCTAACCCTAACCCTAACCCTAACCCTAACCCTAACCCTAACCCTAACCCTAACCCTAACCCTAA
ptg001917l polypolish	reverse	GGTTAGGGTTAGGGTTAGGGTTAGGGTTAGGGTTAGGGTTAGGGTTAGGGTTAGGGTTAGGGTTAGGGTTAGAGCATAGAGTTATGGTAGACCGGGCATA
ptg001921l polypolish	forward	TAACCCTAACCCTAACCCTAACCCTAACCCTAACCCTAACCCTAACCCTAACCCTAACCCTAACCCTAACCCTAACCCTAACCCTAACCCTAACCCTAAC
ptg001929l polypolish	reverse	TAGGGTTAGGGTTAGGGTTAGGGTTAGGGTTAGGGTTAGGGTTAGGGTTAGGGTTAGGGTTAGGGTTAGGGTTAAGACCAGGCTTAGGGTAGTAGGGTTA
ptg001961l polypolish	reverse	TTAGGGTTAGGGTTAGGGTTAGGGTTAGGGTTAGGGTTAGGGTTAGGGTTAGGGTTAGGGTTAGGGATTTAGGGTAGCAATACGTGGCCGTAATGAACAA
ptg001964l polypolish	reverse	GGGTTAGGGTTAGGGTTAGGGTTAGGGTTAGGGTTAGGGTTAGGGTTAGGGTTAGGGTTAGGGTTAGCATATAGGGTTAGGGTTAGGGTAGCATAAACAT
ptg001967l polypolish	forward	TGTAACCCTACTTCGTTAGGGTTACGTATTGCTCCTAACCCTAACCCTAACCCTAACCGTAACCCTAACCCTAACCCTAACCCTAACCCTAACCCTAACC
ptg001969l polypolish	reverse	TTAGGGTTAGGGTTAGGGTTAGGGTTAGGGTTAGGGGTACGGGTTAGGTACCCATAGGTGTAGGGTACAGGATTACAGCGTACATACGGCGCAATGTACT
ptg001970l polypolish	reverse	AGTATTAGGGTTAGGGTTAGGGTTAGGGTTAGGGTTAGGGTTAGGGTTAGGGTTAGGGTTAGGGTTAGGGTTAGGGTTAGGGTTAGGGTTAGGGTTTGAA
ptg001972l polypolish	forward	ACGTTTATGTAACCACTAGTTAGTTACATATACACCCTAACCCTAACCCTAACCCTAACCCTAACCCTAACCCTAACCCTAACCCTAACCCTAACCCTAA
ptg002007l polypolish	reverse	TTAGGGTTAGGGTTAGGGTTAGGGTTAGGGTTAGGGTTAGGGTTAGGGTTAGGGTTAGGGTTAGGGTTAGGGTTAGGGTTAGGGTTAGGGTTAGGGTTAG
ptg002009l polypolish	forward	AGAAATCACCACCCCGATAACCCTAACCCTCTAAATCCCTATCTATCCGACATTCCGGTGCCGAATCCAGATAAAGATGAAAACGGTTCGAGTTCTTGGA
ptg002009l polypolish	reverse	GTTAGGGTTAGGGTTAGGGTTAGGGTTAGGGTTAGGGTTAGGGTTAGGGTTAGGGTTAGGGTTAGGGTTAGGGTTAGGGTTAGGGTTAGGGTTAGGGTTA
ptg002024l polypolish	forward	AACCCTAACCCTAACCCTAACCCTAACCCTAACCCTAACCCTAACCCTAACCCTAACCCTAACCCTAACCCTAACCCTAACCCTAACCCTAACCCTAACC
ptg002026l polypolish	forward	TAACCTGCTTAACTACTTAATGCTCTAACCCTAACCCTAACCCTAACCCTAACCCTAACCCTAACCCTAACCCTAACCCTAACCCTAACCCTAACCCTAA
ptg002050l polypolish	reverse	GGGTTAGGGTTAGGGTTAGGGTTAGGGTTAGGGTTAGGGTTAGGGTTAGGGTTAGGGTTAGTTAGCAATACGACACGAACTGAAAGGCTAGGCTACAGTA
ptg002056l polypolish	forward	GTTATGCTAGTCTACTGGTTCAGTTACCGTAACTACTACCCTAACCCTAACCCTAACCCTAACCCTAACCCTAACCCTAACCCTAACCCTAACCCTAACC
ptg002081l polypolish	reverse	GGGTTAGGGTTAGGGTTAGGGTTAGGGTTAGGGTTAGGGTTAGGGTTAGGGTTAGGGTTAGGCTTAGTAATACAAGGTTTCTTGAACGAAGTTAGGTTAT
ptg002084l polypolish	forward	ATGTTTATGCCTAAGCCTACTAGGCTCTAGTACGCTATTTGCATAAACCCTAACCCTAACCCTAACCCTAACCCTAACCCTAACCCTAACCCTAACCCTA
ptg002162l polypolish	reverse	TAGGGTTAGGGTTAGGGTTAGGGTTAGGGTTAGGGTTAGGGTTAGGGTTAGGGTTAGGGTTAGGGTTAGGGTTAGGGTTAGGGTTATCTCTTACAATTGG
ptg002170l polypolish	reverse	GGTTAGGGTTAGGGTTAGGGTTAGGGTTAGGGTTAGGGTTAGGGTTAGGGTTAGGGTTAGGGTTAGGGTTAGGGTTAGGGTTAGGGTTAGGGTTAGGGTT
ptg002179l polypolish	forward	CTTACCCTATCCCTAACCCTAACCCTAACCCTAACCCTAACCCTAACCCTAACCCTAACCCTAACCCTAACCCTAACCCTAACCCTAACCCTAACCCTAA
ptg002210l polypolish	forward	TGTGTAACCCTATGACGTGTAGCTACTGGTTCACTTACCGTATTGCTTCTCCCTAACCCTAACCCTAACCCTAACCCTAACCCTAACCCTAACCCTAACC
ptg002214l polypolish	forward	AACCCTAACCCTAACCCTAACCCTAACCCTTAACCCTAACTTACCTCAACCCTACTCCCTAACCCTAACCCTAACCCTAACCCTAACCCTAACCCTAACC
ptg002253l polypolish	reverse	GTTAGGGTTAGGGTTAGGGTTAGGGTTAGGGTTAGGGTTAGGGTTAGGGTTAGGGTTAGGGTTAGGGTTAGGGTTAGGGTTAGGGTTAGGGTTAGGGTTA
ptg002256l polypolish	forward	TTTATGGCCAAGTCGAACTTGGTTCAGTAAGGAACTTCAGTTACCCTAACCCTAACCCTAACCCTAACCCTAACCCTAACCCTAACCCTAACCCTAACCC
ptg002265l polypolish	forward	CATAGTGGCTACAGTTCAAATTCGTCTTGCTCAACTCTAGCCCTAACCCTAACCCTAACCCTAACCCTAACCAACCCTAACCCTAACCCTAACCCTAACC
ptg002297l polypolish	reverse	AGGGTTAGGGTTAGGGTTAGGGTTAGGGTTAGGAACGTTAGACTCATAGGTGTTAGAATTAGGGTTAGCGAGCAATACCTGATCTTCTAGTATAGCTATA
ptg002310l polypolish	reverse	GTTAGGGTTAGGGTTAGGGTTAGGGTTAGGGTTAGGGTTAGGGTTAGGGTTAGGGTTAGGGTTAGGGTTAGGGTTAGGGTTAGGGTTAGGGTTAGGGTTA
ptg002318l polypolish	forward	ATTTGGCCCTAACCCTGGTTCAGTTAACCCTAACCCTAACCCTAACCCTAACCCTAACCCTAACCCTAACCCTAACCCTAACCCTAACCCTAACCCTAAC
ptg002323l polypolish	reverse	TTAGGGTTAGGGTTAGGGTTAGGGTTAGGGTTAGGGTTAGGGTTAGGGTTAGGGTTAGGGTTAGGGTTAGGGTTAGGGTTAGGGTTAGGGTTAGGGTTAG
ptg002332l polypolish	reverse	AGGGTTAGGGTTAGGGTTAGGGATTAGGGTTAGGGTTAGGGTTAGGGTTAGGGTTAGGGTTAGGGTAGCAATAGGGTTTAGGGTTAGGGTTACATAAACA
ptg002335l polypolish	forward	TGTCATCCTACTTGGTTCAGTTACATCTATGCCTGCCCTAACCATCTAACCCTAACCCTAACCCTAACCCTAACCCTAACCCTAACCCTAACCCTAACCC
ptg002348l polypolish	forward	ATGATCTCTTCAACATCGGTATTGCTACTAACTTAACTCTATGTATAGTCTAACCTAACCCTAACCCTAACCCTAACCCTAACCCTAACCCTAACCCTAA
ptg002384l polypolish	reverse	TAGGGTTAGGGTTAGGGTTAGGGTTAGGGTTAGGGTTAGGGTTAGGGTTAGGGTTAGGGTTAGGGTTAGGGTTAGGGTTAGGGTTAGGGTTAGGGTTAGG
ptg002407l polypolish	reverse	GTTAGGGTTAGGGTTAGGGTTAGGGTTAGGGTTAGGGTTAGGGTTAGGGTTAGGGTTAGGGTTAGGGTTAGGGTTAGGGTATAGACTAACTTAAGTCTAG
ptg002453l polypolish	reverse	TTAGGGTTAGGGTTAGGGTTAGGGTTAGGGTTAGGGTTAGGGTTAGGGTTAGGGTTAGGGTTAGGGTTAGGGTTAGGGTTAGGGTTACAGCATAGGGTTA
ptg002495l polypolish	forward	CCCTAACCCTAACCCTAACCCTAACCCTAACCCTAACCCTAACCCTAACCCTAACCCTAACCCTAACCCTAACCCTAACCCTAACCCTAACCCTAACCCT
ptg002503l polypolish	reverse	GGTTAGGGTTAGGGTTAGGGTTAGGGTTAGGGTTAGGGTTAGGGTTAGGGTTAGGGTTAGGGTTAGGGTTAGGGTTAGGGTTAGGGTTAGGGTTAGGGTT
ptg002507l polypolish	forward	ACTAACCCTAACCCTAACCCTAACCCTAACCCTAACCCTAACCCTAACCCTAACCCTAACCCTAACCCTAACCCTAACCCTAACCCTAACCCTAACCCTA
ptg002510l polypolish	forward	GCCAATTGTACTAACCCTAACCCTAAGGCTAACCTAACCCTATTCCCAACCCTGTACTGGTTCAGTAACCCTAACCCTAACCCTAACCCTAACCCTAACC
ptg002514l polypolish	reverse	TTAGGGTTAGGGTTAGGGTTAGGGTTAGGGTTAGGGTTAGGGTTAGGGTTAGGGTTAGGGTTAGGGTTAGGGTTAGGGTTAGGGTTAGGGTTAGGGTTAG
ptg002544l polypolish	reverse	TAGGGTTAGGGTTAGGGTTAGGGTTAGGGTTAGGGTTAGGGTTAGGGTTAGGGTAGGGTTAACCTAACCAAGGCTAGCATGAGTCAAGGTATAGTTAACA
ptg002607l polypolish	reverse	GGGTTAGGGTTAGGGTTAGGGTTAGGGTTAGGGTTAGGGTTAGGGTTAGGGTTAGGGTTAGGGTTAGGGTTAGGGTACAGGGTTACCAGGGTTAGGGTTA
ptg002696l polypolish	reverse	TAGGGTTAGGGTTAGGGTTAGGGTTAGGGTTAGGGTTAGGGTTAGGGTTAGGGTTAGGGTTAGGGTAGCAAGCACGTAACTGAACCAGTAGGTTAGGCAT
ptg002700l polypolish	reverse	GTTAGGGTTAGGGTTAGGGTTAGGGTTAGGGTTAGGGTTAGGGTTAGGGTTAGGGTTAGGGTTAGGGTTAGGGTTAGGGTTAGGGTTAGGGTTAGGGTTA
ptg002717l polypolish	reverse	AGGGTTAGGGTTAGGGTTAGGGTTAGGGTTAGGGTTAGGGTTAGGGTTAGGGTTAGGCTTAGGACTAGGAGTAATACGTAGTCTAAACGTAGGCAGACAT
ptg002774l polypolish	reverse	GTTAGGGTTAGGGTTAGGGTTAGGGTTAGGGTTAGGGTTAGGGTTAGGGTTAGGGTTAGGGTTAGGGTTAGGGTTAGGGTTAGGGTTAGGGACTAACATA
ptg002776l polypolish	reverse	GGGTTAGGGTTAGGGTTAGGGTTAGGGTTAGGGTTAGGGTTAGGGTTAGGGTTAGGGTTAGGGTTAGGGTTAGGGTTAGGGTTAGGGTTAGGGTTAGGGT
ptg002818l polypolish	forward	TAACCCTAACCCTAACCCTAACCCTAACCCTAACCCTAACCCTAACCCTAACCCTAACCCTAACCCTAACCCTAACCCTAACCCTAACCCTAACCCTAAC

Telomeres found: 401 (186 forward, 215 reverse)
